border_size=1
usage=map

Gs^Fds      , Gs^Fds      , Gs^Fds      , Gs^Fds      , Gs^Fds      , Gs^Fds      , Gs^Fds      , Gs^Fds      , Gs^Fds      , Gs^Fds      , Wo          , Wo          , Kh          , Ch          , Kh          , Kh          , Ch          , Wo          , Wo          , Gs^Fp       , Gs^Fp       , Re^Gvs      , Re^Gvs      , Re^Gvs      , Re^Gvs      , Re^Gvs      , Re^Gvs      
Gs^Fds      , Gs^Fds      , Gs^Fp       , Gs^Fds      , Gs^Fds      , Gs^Fds      , Gs^Fds      , Gs^Fds      , Wo          , Wo          , Ch          , Ch          , Rr          , Kh          , Rr          , Ch          , Ch          , Ch          , Ch          , Wo          , Wo          , Re^Gvs      , Gg^Vl       , Re^Gvs      , Re^Gvs      , Re^Gvs      , Re^Gvs      
Gs^Fds      , Gs^Fds      , Gs^Fds      , Gs^Fds      , Gs^Fds      , Gs^Fds      , Wo          , Wo          , Ch          , Ch          , Rr          , Rr          , Rr          , Rr          , Rr          , Rr          , Rr          , Ch          , Ch          , Ch          , Ch          , Wo          , Wo          , Gg          , Gs^Fp       , Re^Gvs      , Gs^Fp       
Gs^Fds      , Gs^Fds      , Gs^Fds      , Gs^Fds      , Wo          , Wo          , Ch          , Ch          , Rr          , Rr          , Rr          , Rr          , Rr          , Rr          , Rr          , Rr          , Rr          , Rr          , Rr          , Ch          , Ch          , Ch          , Ch          , Wo          , Wo          , Gs^Fp       , Gs^Fp       
Gs^Fds      , Gs^Fds      , Wo          , Wo          , Ch          , Ch          , Rr          , Rr          , Rr          , Rr          , Rr          , Rr          , Rr          , Rr          , Rr          , Rr          , Rr          , Rr          , Rr          , Rr          , Rr          , Ch          , Ch          , Ch          , Ch          , Wo          , Wo          
Wo          , Wo          , Ch          , Ch          , Rr          , Rr          , Rr          , Rr          , Cud         , Cud         , Cud         , Rr          , Rr          , Rr          , Rr          , Rr          , Rp          , Rr          , Rr          , Rr          , Rr          , Rr          , Rr          , Ch          , Ch          , Kh          , Wo          
Kh          , Kh          , Rr          , Rr          , Rr          , Rr          , Cud         , Cud         , Cv          , Cud         , Cud         , Cud         , Cud         , Rr          , Rr          , Rr          , Rr          , Rr          , Rr          , Rr          , Rr          , Rr          , Ch          , Ch          , Wo          , Wo          , Gs^Fp       
Ch          , Ch          , Rr          , Rr          , Cud         , Cud         , Cv          , Cv          , Cv          , Cv          , Cv          , Cud         , Cud         , Cud         , Cud         , Rr          , Rr          , Rr          , Rr          , Rp^Vhc      , Ch          , Ch          , Wo          , Wo          , Gs^Fp       , Gs^Fp       , Gg          
Ch          , Ch          , Rr          , Cud         , Cv          , Cv          , Cv          , Cv          , Rp          , Cv          , Cv          , Cv          , Cv          , Cud         , Cud         , Cud         , Cud         , Rr          , Rr          , Kh          , Wo          , Wo          , Gs^Fp       , Gs^Fp       , Gg          , Gg          , Gg          
Ch          , Ch          , Rr          , Cud         , Cv          , Cv          , Rp          , Rp          , Rp          , 1 Rp        , Rp          , Cv          , Kv          , Cv          , Kv          , Cud         , Cud         , Cud         , Kud         , Rd          , Wo^Bw/      , Re          , Re          , Gg          , Gg^Ve       , Gg          , Gg          
Ch          , Ch          , Rr          , Cud         , Cv          , Cv          , Rp          , Rp          , Rp          , Rp          , Rp          , Cv          , Kv          , Kv          , Kv          , Cud         , Cud         , Cud         , Kud         , Cud         , Wo          , Rd          , Gs^Fp       , Re          , Re          , Re          , Re          
Ch          , Ch          , Rr          , Cud         , Cv          , Cv          , Rp          , 2 Rp        , Rp          , Rp          , Cv          , Cv          , Cv          , Cv          , Cud         , Cud         , Cud         , Cud         , Rr          , Rd          , Wo          , Rd          , Gs^Fp       , Gg          , Gg          , Gg          , Gg          
Ch          , Ch          , Rr          , Cud         , Cv          , Cv          , Rp          , Rp          , Cv          , Cv          , Cv          , Cv          , Xos         , Cud         , Cud         , Cud         , Rr          , Rr          , Rr          , Kh          , Ch          , Wo          , Wo          , Gs^Fp       , Gs^Fp       , Gg          , Gg          
Ch          , Ch          , Rr          , Cud         , Cv          , Cv          , Cv          , Cv          , Cv          , Cv          , Xos         , Cud         , Cud         , Cud         , Xos         , Rr          , Xos         , Rr          , Xos         , Rr          , Rr          , Ch          , Ch          , Wo          , Wo          , Gs^Fp       , Gs^Fp       
Ch          , Ch          , Rr          , Cud         , Xos         , Cv          , Cv          , Cv          , Xos         , Cud         , Cud         , Cud         , Xos         , Xos         , Rr          , Xos         , Rr          , Xos         , Rr          , Xos         , Xos         , Rr          , Rr          , Ch          , Ch          , Wo          , Wo          
Ch          , Ch          , Rr          , Cud         , Cud         , Cud         , Xos         , Cud         , Cud         , Cud         , Xos         , Xos         , Rp^Vhc      , Rr          , Xos         , Rr          , Xos         , Rr          , Rr          , Rr          , Xos         , Rr          , Rr          , Rp^Vhc      , Ch          , Kh          , Wo          
Ch          , Ch          , Rr          , Cud         , Xos         , Cud         , Cud         , Cud         , Xos         , Xos         , Rr          , Xos         , Xos         , Rr          , Rr          , Xos         , Rr          , Rr          , Xos         , Xos         , Rr          , Rr          , Ch          , Ch          , Ch          , Kh          , Wo          
Ch          , Ch          , Rr          , Cud         , Cud         , Cud         , Xos         , Rr          , Rr          , Rr          , Xos         , Rr          , Rr          , Rr          , Xos         , Xos         , Rr          , Xos         , Rr          , Rr          , Ch          , Ch          , Ch          , Ch          , Wo          , Wo          , Gs^Fp       
Ch          , Ch          , Rr          , Cud         , Rp^Vhc      , Rr          , Rr          , Xos         , Xos         , Xos         , Rr          , Xos         , Xos         , Xos         , Rr          , Rr          , Xos         , Xos         , Ch          , Ch          , Ch          , Ch          , Wo          , Wo          , Gs^Fp       , Gs^Fp       , Gs^Fp       
Ch          , Ch          , Ch          , Rr          , Rr          , Rr          , Rr          , Rr          , Rr          , Rr          , Xos         , Rr          , Rr          , Rr          , Xos         , Xos         , Ch          , Ch          , Ch          , Ch          , Wo          , Wo          , Gs^Fp       , Gs^Fp       , Gs^Fp       , Gs^Fp       , Gs^Fp       
Ch          , Ch          , Ch          , Ch          , Ch          , Rr          , Ch          , Rr          , Ch          , Rr          , Ch          , Xos         , Xos         , Xos         , Xos         , Xos         , Xos         , Ch          , Wo          , Wo          , Gs^Fp       , Gs^Fp       , Gs^Fp       , Gs^Fp       , Gs^Fp       , Gs^Fds      , Gs^Fp       
Xu          , Ch          , Ch          , Ch          , Ch          , Ch          , Ch          , Ch          , Ch          , Ch          , Xos         , Xos         , Xos         , Xos         , Xos         , Xos         , Xos         , Xos         , Xos         , Gs^Fp       , Gs^Fp       , Gs^Fp       , Gs^Fp       , Gs^Fp       , Gs^Fp       , Gs^Fp       , Gs^Fp       
Xu          , Xu          , Xu          , Xu          , Xu          , Xu          , Xos         , Xos         , Xos         , Xos         , Xos         , Xos         , Xos         , Xos         , Uu          , Xos         , Xos         , Xos         , Xos         , Xos         , Xos         , Xos         , Xu          , Xu          , Xu          , Xu          , Xu          
Xu          , Uh          , Uu          , Uu          , Uu          , Uh          , Xos         , Xos         , Xos         , Xos         , Xos         , Xos         , Uu          , Uh          , Uu          , Uu          , Uu          , Xos         , Xos         , Xos         , Xos         , Xos         , Uu          , Uu          , Xu          , Uh          , Hd          
Xu          , Xu          , Ur          , Ur          , Ur          , Xos         , Xos         , Xos         , Xos         , Xos         , Uu          , Ur          , Ur          , Uu          , Ur          , Ur          , Uu          , Uu          , Xos         , Xos         , Xos         , Xos         , Ur          , Uh^Dr       , Xu          , Hd^Dr       , Hd          
Xu          , Uh          , Uu          , Uu          , Uu          , Ur          , Uu          , Xos         , Uu          , Uu          , Xos         , Xos         , Xos         , Ur          , Uu          , Uu          , Xos         , Xos         , Xos         , Xos         , Xos         , Xos         , Xos         , Uh          , Xos         , Hd          , Hd          
Xu          , Ss          , Ww^Bw|      , Ww          , Ss          , Ww          , Ss          , Ww          , Ss          , Xos         , Xos         , Xos         , Xos         , Xos         , Xos         , Xos         , Xos         , Xos         , Xos         , Xos         , Ww          , Xos         , Ww          , Xos         , Ww          , Ww          , Ww          
Xu          , Ww          , Ww^Bw|      , Ww          , Ww          , Ww          , Ww          , Ww          , Ww          , Ww          , Ww          , Xos         , Xos         , Xos         , Xos         , Xos         , Xos         , Xos         , Wo          , Ww          , Wo          , Ww          , Wo          , Wo          , Ww          , Ww          , Ww          
Ww          , Ww          , Wo^Bw|      , Wo          , Wo          , Ww          , Wo          , Wo          , Wo          , Ww          , Wo          , Wo          , Wo          , Xos         , Xos         , Xos         , Wo          , Wo          , Wo          , Wo          , Wo          , Wo          , Wo          , Wo          , Wo          , Ur          , Xu          
Wo          , Wo          , Ss          , Wo          , Wo          , Wo          , Wo          , Wo          , Wo          , Wo          , Wo          , Wo          , Wo          , Wo          , Wo          , Wo          , Wo          , Wo          , Wo          , Wo          , Wo          , Wo          , Wo          , Ww          , Ur          , Ur          , Xu          
Ss          , Ss          , Wo^Bw|      , Wo          , Uu          , Wo^Dr       , Wo          , Wo          , Uu^Vud      , Wo          , Wo          , Wo          , Ur          , Uh          , Uu          , Uh          , Uh          , Uu          , Uu          , Wo^Dr       , Ur          , Uh          , Uh          , Uh          , Uh          , Ur          , Xu          
Xu          , Uh          , Ur          , Uh          , Uh          , Uh          , Ur          , Uu          , Ur          , Ur          , Ur          , Uh          , Uh          , Ur          , Uh          , Ur          , Ur          , Ur          , Ur          , Ur          , Uh          , Ur          , Ur          , Ur          , Uh          , Uh^Dr       , Xu          
Xu          , Uh          , Uh^Dr       , Ur          , Ur          , Xos         , Uh          , Uh          , Uh          , Xos         , Uh          , Ur          , Uh          , Xos         , Uh          , Uh          , Uh          , Xos         , Uh          , Uh          , Uh          , Xos         , Xu          , Xu          , Xu          , Xu          , Xu          
Xu          , Xu          , Xu          , Xu          , Xu          , Uu^Dr       , Xu          , Xu          , Xu          , Uu^Dr       , Xu          , Xu          , Xu          , Uu^Dr       , Xu          , Xu          , Xu          , Uu          , Xu          , Xu          , Xu          , Xu          , Xu          , Xu          , Xu          , Xu          , Xu          
