border_size=1
usage=map

Xos         , Xos         , Xos         , Xos         , Xos         , Xos         , Xos         , Xos         , Xos         , Xos         , Xos         , Xos         , Xos         , Xos         , Gs^Fds      , Gs^Fds      , Gs^Fds      , Gs^Fds      , Gs^Fds      , Gs^Fds      , Gs^Fds      , Gs^Fds      , Gs^Fds      , Gs^Fds      , Gs^Fds      , Gs^Fds      , Gs^Fds      , Gs^Fds      , Gs^Fds      , Gs^Fds      , Wo          , Wo          , Kh          , Ch          , Kh          , Kh          , Ch          , Wo          , Wo          , Gs^Fp       , Gs^Fp       , Re^Gvs      , Re^Gvs      , Re^Gvs      , Re^Gvs      , Re^Gvs      , Re^Gvs      
Xos         , Rr          , Rr          , Rr          , Rr          , Rr          , Rr          , Rr          , Rr          , Rr          , Rr          , Rr          , Rr          , Xos         , Gs^Fds      , Gs^Fds      , Gs^Fds      , Gs^Fds      , Gs^Fds      , Gs^Fds      , Gs^Fds      , Gs^Fds      , Gs^Fp       , Gs^Fds      , Gs^Fds      , Gs^Fds      , Gs^Fds      , Gs^Fds      , Wo          , Wo          , Ch          , Ch          , Rr          , Kh          , Rr          , Ch          , Ch          , Ch          , Ch          , Wo          , Wo          , Re^Gvs      , Gg^Vl       , Re^Gvs      , Re^Gvs      , Re^Gvs      , Re^Gvs      
Xos         , Rr          , Xos         , Rr          , Xos         , Rr          , Xos         , Rr          , Rr          , Rr          , Rr          , Rr          , Rr          , Xos         , Gs^Fds      , Gs^Fds      , Gs^Fds      , Gs^Fds      , Gs^Fds      , Gs^Fds      , Gs^Fds      , Gs^Fds      , Gs^Fds      , Gs^Fds      , Gs^Fds      , Gs^Fds      , Wo          , Wo          , Ch          , Ch          , Rr          , Rr          , Rr          , Rr          , Rr          , Rr          , Rr          , Ch          , Ch          , Ch          , Ch          , Wo          , Wo          , Gg          , Gs^Fp       , Re^Gvs      , Gs^Fp       
Xu          , Rr          , Rr          , Rr          , Rr          , Rr          , Rr          , Xos         , Rr          , Rr          , Xos         , Rr          , Rr          , Xos         , Gs^Fds      , Gs^Fds      , Gs^Fds      , Gs^Fds      , Gs^Fds      , Gs^Fds      , Gs^Fds      , Gs^Fds      , Gs^Fds      , Gs^Fds      , Wo          , Wo          , Ch          , Ch          , Rr          , Rr          , Rr          , Rr          , Rr          , Rr          , Rr          , Rr          , Rr          , Rr          , Rr          , Ch          , Ch          , Ch          , Ch          , Wo          , Wo          , Gs^Fp       , Gs^Fp       
Xu          , Xos         , Rr          , Xos         , Rr          , Xos         , Rr          , Xos         , Rr          , Rr          , Rr          , Rr          , Rr          , Xos         , Gs^Fds      , Gs^Fds      , Gs^Fds      , Gs^Fds      , Gs^Fds      , Gs^Fds      , Gs^Fds      , Gs^Fds      , Wo          , Wo          , Ch          , Ch          , Rr          , Rr          , Rr          , Rr          , Rr          , Rr          , Rr          , Rr          , Rr          , Rr          , Rr          , Rr          , Rr          , Rr          , Rr          , Ch          , Ch          , Ch          , Ch          , Wo          , Wo          
Xu          , Rr          , Xos         , Rr          , Xos         , Rr          , Rr          , Xos         , Rr^Vhc      , Rr          , Xos         , Rr          , Rr          , Xos         , Gs^Fds      , Gs^Fds      , Gs^Fds      , Gs^Fds      , Xos         , Gs^Fds      , Wo          , Wo          , Ch          , Ch          , Rr          , Rr          , Rr          , Rr          , Cud         , Cud         , Cud         , Rr          , Rr          , Rr          , Rr          , Rr          , Rp          , Rr          , Rr          , Rr          , Rr          , Rr          , Rr          , Ch          , Ch          , Kh          , Wo          
Xu          , Rr          , Rr          , Rr          , Rr          , Rr          , Rr          , Xos         , Xos         , Xos         , Rr          , Rr          , Rr          , Xos         , Gs^Fds      , Gs^Fds      , Xos         , Xos         , Rr          , Xos         , Kh          , Kh          , Rr          , Rr          , Rr          , Rr          , Cud         , Cud         , Cv          , Cud         , Cud         , Cud         , Cud         , Rr          , Rr          , Rr          , Rr          , Rr          , Rr          , Rr          , Rr          , Rr          , Ch          , Ch          , Wo          , Wo          , Gs^Fp       
Xu          , Xos         , Rr          , Xos         , Rr          , Xos         , Rr          , Xos         , Rr          , Rr          , Xos         , Rr          , Rr^Vhh      , Xos         , Xos         , Xos         , Rr          , Rr          , Rr          , Xos         , Ch          , Ch          , Rr          , Rr          , Cud         , Cud         , Cv          , Cv          , Cv          , Cv          , Cv          , Cud         , Cud         , Cud         , Cud         , Rr          , Rr          , Rr          , Rr          , Rr^Ve       , Ch          , Ch          , Wo          , Wo          , Gs^Fp       , Gs^Fp       , Gg          
Xu          , Rr          , Xos         , Rr          , Xos         , Rr          , Rr          , Xos         , Rr          , Rr          , Rr          , Rr          , Xos         , Xos         , Rr          , Rr          , Wo          , Wo          , Rr          , Xos         , Ch          , Ch          , Rr          , Cud         , Cv          , Cv          , Cv          , Cv          , Rp          , Cv          , Cv          , Cv          , Cv          , Cud         , Cud         , Cud         , Cud         , Rr          , Rr          , Kh          , Wo          , Wo          , Gs^Fp       , Gs^Fp       , Gg          , Gg          , Gg          
Xu          , Rr          , Rr          , Rr          , Rr          , Rr          , Rr          , Xos         , Rr          , Rr          , Xos         , Xos         , Rr          , Rr          , Rp          , Wo          , Wo          , Rr          , Rr          , Xos         , Ch          , Ch          , Rr          , Cud         , Cv          , Cv          , Rp          , Rp          , Rp          , Rp          , Rp          , Cv          , Kv          , Cv          , Kv          , Cud         , Cud         , Cud         , Kud         , Rd          , Wo^Bw/      , Re          , Re          , Gg          , Gs^Vh       , Gg          , Gg          
Xu          , Xos         , Rr          , Xos         , Rr          , Xos         , Rr          , Xos         , Rr          , Rr          , Rr          , Rr          , Rr          , Rr          , Wo          , Wo          , Rp          , Rr          , Rr          , Xos         , Ch          , Ch          , Rr          , Cud         , Cv          , Cv          , Rp          , Rp          , Rp          , Rp          , Rp          , Cv          , Kv          , Kv          , Kv          , Cud         , Cud         , Cud         , Kud         , Cud         , Wo          , Rd          , 1 Gs^Fp     , Re          , Re          , Re          , Re          
Xos         , Rr          , Xos         , Rr          , Rr          , Rr          , Xos         , Xos         , Rr          , Rr          , Rr          , Rr          , Rr          , Rr          , Rp          , Wo          , Wo          , Rr          , Rr          , Xos         , Ch          , Ch          , Rr          , Cud         , Cv          , Cv          , Rp          , Rp          , Rp          , Rp          , Cv          , Cv          , Cv          , Cv          , Cud         , Cud         , Cud         , Cud         , Rr          , Rd          , Wo          , Rd          , Gs^Fp       , Gg          , Gg          , Gg          , Gg          
Xos         , Rr          , Rr          , Rr          , Xos         , Xos         , Rr          , Rr          , Rr          , Rr          , Rr          , Rr          , Rr          , Rr          , Wo          , Wo          , Rp          , Rr          , Rr          , Xos         , Ch          , Ch          , Rr          , Cud         , Cv          , Cv          , Rp          , Rp          , Cv          , Cv          , Cv          , Cv          , Xos         , Cud         , Cud         , Cud         , Xos         , Rr          , Rr          , Kh          , Ch          , Wo          , Wo          , Gs^Fp       , Gs^Fp       , Gg          , Gg          
Xos         , Rr          , Rr          , Xos         , Rr          , Rr          , Rr          , Rr          , Rr          , Rr          , Rr          , Rr          , Rr          , Rr          , Rp          , Wo          , Wo          , Rr          , Rr          , Xos         , Xos         , Ch          , Rr          , Cud         , Cv          , Cv          , Cv          , Cv          , Cv          , Cv          , Xos         , Cud         , Cud         , Cud         , Xos         , Xos         , Iwr         , Xos         , Xos         , Rr          , Rr          , Ch          , Ch          , Wo          , Wo          , Gs^Fp       , Gs^Fp       
Xos         , Rr          , Rr          , Xos         , Xos         , Rr          , Rr          , Rr          , Rr          , Rr          , Rr          , Rr          , Rr          , Rr          , Wo          , Wo          , Rp          , Rr          , Rr^Dr       , Re          , Ch          , Xos         , Rr          , Cud         , Xos         , Cv          , Cv          , Cv          , Xos         , Cud         , Cud         , Cud         , Xos         , Xos         , Iwr         , Iwr         , Xos         , Xos         , Iwr         , Xol         , Xol         , Rr          , Rr          , Ch          , Ch          , Wo          , Wo          
Xos         , Rr          , Rr          , Rr          , Rr          , Xos         , Xos         , Rr          , Rr          , Rr          , Rr          , Rr          , Rr          , Rr          , Rp          , Wo          , Wo          , Rr          , Rr          , Xos         , Ch          , Xos         , Rr          , Cud         , Cud         , Cud         , Xos         , Cud         , Cud         , Cud         , Xos         , Xos         , Iwr         , Iwr         , Xos         , Iwr         , Iwr         , Iwr         , Iwr^Vh      , 6 Iwr       , Iwr         , Xos         , Xos         , Rp^Vhc      , Ch          , Kh          , Wo          
Xu          , Xos         , Xos         , Rr          , Rr          , Rr          , Rr          , Xol         , Xol         , Rr          , Rr          , Rr          , Rr          , Rr          , Wo          , Wo          , Rp          , Rr          , Rr          , Xos         , Ch          , Xos         , Rr          , Cud         , Xos         , Cud         , Cud         , Cud         , Xos         , Xos         , Iwr         , Xos         , Xos         , Iwr         , Iwr         , Xos         , Iwr         , Iwr         , Xos         , Xos         , Xos         , Xos         , Ch          , Ch          , Ch          , Kh          , Wo          
Xu          , Iwr         , Iwr         , Xos         , Xos         , Rr          , Rr          , Rr          , Rr          , Xos         , Xos         , Rr          , Rr          , Rr          , Rp          , Wo          , Wo          , Rr          , Rr          , Xos         , Ch          , Xos         , Rr          , Cud         , Cud         , Cud         , Xos         , Iwr         , Iwr         , Iwr         , Xos         , Iwr         , Iwr         , Iwr         , Xos         , Xos         , Iwr         , Xos         , Iwr         , Iwr         , Ch          , Ch          , Ch          , Ch          , Wo          , Wo          , Gs^Fp       
Xu          , Iwr         , Xos         , Iwr         , Iwr         , Xos         , Xos         , Rr          , Rr          , Rr          , Rr^Vo       , Xos         , Xos         , Rr          , Rr          , Wo          , Wo          , Rr          , Rr          , Xos         , Ch          , Xos         , Rr          , Cud         , Rp^Vhc      , Rr          , Rr          , Xos         , Xos         , Xos         , Iwr         , Xos         , Xos         , Xos         , Iwr         , Iwr         , Xos         , Xos         , Ch          , Ch          , Ch          , Ch          , Wo          , Wo          , Gs^Fp       , Gs^Fp       , Gs^Fp       
Xu          , Iwr         , Iwr         , Iwr         , Iwr         , Iwr         , Iwr         , Iwr         , Iwr         , Rr          , Xos         , Rr          , Rr          , Xos         , Xos         , Rr          , Rr          , Wo          , Rr          , Xos         , Ch          , Xos         , Xos         , Rr          , Xos         , Rr          , Rr          , Rr          , Iwr         , Iwr         , Xos         , Iwr         , Iwr         , Iwr         , Xos         , Xos         , Ch          , Ch          , Ch          , Ch          , Wo          , Wo          , Gs^Fp       , Gs^Fp       , Gs^Fp       , Gs^Fp       , Gs^Fp       
Xu          , Xos         , Iwr         , Xos         , Iwr         , Xos         , Iwr         , Xos         , Iwr         , Iwr         , Iwr         , Xos         , Xos         , Rr          , Rr          , Xos         , Xol         , Rr          , Rr          , Xos         , Ch          , Ch          , Ch          , Xos         , Ch          , Xos         , Xos         , Xos         , Xos         , Xos         , Ch          , Xos         , Xos         , Xos         , Ch          , Ch          , Ch          , Ch          , Wo          , Wo          , Gs^Fp       , Gs^Fp       , Gs^Fp       , Gs^Fp       , Gs^Fp       , Gs^Fds      , Gs^Fp       
Xu          , Iwr         , Xos         , Iwr         , Xos         , Iwr         , Xos         , Iwr         , Xos         , Iwr         , Xos         , Iwr         , Iwr         , Xos         , Xos         , Rr          , Rr          , Xol         , Xos         , Xos         , Ch          , Ch          , Ch          , Ch          , Ch          , Ch          , Ch          , Ch          , Ch          , Ch          , Ch          , Ch          , Ch          , Ch          , Ch          , Ch          , Xu          , Xu          , Xu          , Xu          , Xu          , Xu          , Xu          , Xu          , Xu          , Xu          , Xu          
Xu          , Iwr         , Iwr         , Iwr         , Iwr         , Iwr         , Iwr         , Iwr         , Iwr         , Iwr         , Iwr         , Iwr         , Iwr         , Iwr         , Iwr         , Xos         , Xos         , Rr          , Rr          , Xos         , Xu          , Xu          , Xu          , Xu          , Xu          , Xu          , Xu          , Xu          , Xu          , Xu          , Xu          , Xu          , Xu          , Xu          , Xu          , Xu          , Xu          , Xu          , Xu          , Xu          , Xu          , Xu          , Xu          , Xu          , Xu          , Xu          , Xu          
Xu          , Xos         , Iwr         , Xos         , Iwr         , Xos         , Iwr         , Xos         , Iwr         , Xos         , Iwr         , Xos         , Iwr         , Xos         , Iwr         , Iwr         , Iwr         , Xos         , Xos         , Xos         , Xu          , Xu          , Uu          , Uu          , Uu          , Uh          , Uu          , Uu^Dr       , Ur          , Uu          , Ur          , Uh          , Uu          , Uh          , Uu          , Uu          , Uu          , Uu          , Uu          , Uh^Dr       , Uu          , Uu^Uf       , Uu          , Uu          , Xu          , Uh          , Hd          
Xu          , Iwr         , Xos         , Iwr         , Xos         , Iwr         , Xos         , Iwr         , Xos         , Iwr         , Xos         , Iwr         , Xos         , Iwr         , Xos         , Iwr         , Xos         , Iwr         , Xos         , Xu          , Xu          , Xu          , Ur          , Ur          , Ur          , Xos         , Ur          , Ur          , Uu          , Uu          , Uu          , Ur          , Ur          , Xos         , Ur          , Ur          , Ur          , Uu          , Ww^Vm       , Ur          , Ur          , Xos         , Ur          , Uh^Dr       , Xu          , Hd^Dr       , Hd          
Xu          , Iwr         , Iwr         , Iwr         , Iwr         , Iwr         , Iwr         , Iwr         , Iwr         , Iwr         , Iwr         , Iwr         , Iwr         , Iwr         , Iwr         , Iwr         , Iwr         , Iwr         , Iwr         , Xu          , Xu          , Uh          , Uu          , Uu          , Uu          , Ur          , Uu          , Uu^Uf       , Uu          , Uu          , Uu          , Uu          , Wwg         , Ur          , Wwg         , Uu          , Wwg         , Uu^Ii       , Wwg         , Ss          , Wwg         , Uu          , Wwg         , Uh          , Wog         , Hd          , Hd          
Xu          , Xos         , Iwr         , Xos         , Iwr         , Xos         , Iwr         , Xos         , Iwr         , Xos         , Iwr         , Xos         , Iwr         , Xos         , Iwr         , Xos         , Iwr         , Xos         , Iwr         , Xu          , Xu          , Ss          , Ww^Bw|      , Wwg         , Ss          , Wwg         , Ss          , Wwg         , Ss          , Ss          , Ss          , Ss          , Wwg         , Wwg         , Wwg         , Wwg         , Wwg         , Ss          , Wwg         , Wwg         , Wwg         , Wwg         , Wwg         , Wog         , Wwg         , Wwg         , Wwg         
Xu          , Iwr         , Xos         , Iwr         , Xos         , Iwr         , Xos         , Iwr         , Xos         , Iwr         , Xos         , Iwr         , Xos         , Iwr         , Xos         , Iwr         , Xos         , Iwr         , Xos         , Xu          , Xu          , Wwg         , Ww^Bw|      , Wwg         , Wwg         , Wwg         , Wwg         , Wwg         , Wwg         , Wwg         , Wwg         , Wwg         , Wog         , Wwg         , Wog         , Wwg         , Wog         , Wwg         , Wog         , Wwg         , Wog         , Wwg         , Wog         , Wog         , Wwg         , Wwg         , Wwg         
Xu          , Iwr         , Iwr         , Iwr         , Iwr         , Iwr         , Iwr         , Iwr         , Iwr         , Iwr         , Iwr         , Iwr         , Iwr         , Iwr         , Iwr         , Iwr         , Iwr         , Iwr         , Iwr         , Xu          , Wwg         , Wwg         , Wo^Bw|      , Wog         , Wog         , Wwg         , Wog         , Wog         , Wog         , Wwg         , Wog         , Wog         , Wog         , Wog         , Wog         , Wog         , Wog         , Wog         , Wog         , Wog         , Wog         , Wog         , Wog         , Wog         , Wog         , Ur          , Xu          
Xu          , Xos         , Iwr         , Xos         , Iwr         , Xos         , Iwr         , Xos         , Iwr         , Xos         , Iwr         , Xos         , Iwr         , Xos         , Iwr         , Xos         , Iwr         , Xos         , Iwr         , Xu          , Wog         , Wog         , Ss          , Wog         , Wog         , Wog         , Wog         , Wog         , Wog         , Wog         , Wog         , Wog         , Wog         , Wog         , Wog         , Wog         , Wog         , Wog         , Wog         , Wog         , Wog         , Wog         , Wog         , Wwg         , Ur          , Ur          , Xu          
Xu          , Iwr         , Xos         , Iwr         , Xos         , Iwr         , Xos         , Iwr         , Xos         , Iwr         , Xos         , Iwr         , Xos         , Iwr         , Xos         , Iwr         , Xos         , Iwr         , Xos         , Xu          , Ss          , Ss          , Wo^Bw|      , Wog         , Uu          , Wog         , Wog         , Wog         , Uu^Vud      , Wog         , Wog         , Wog         , Ur          , Uh          , Uu          , Uh          , Uh          , Uu          , Uu          , Wog         , Ur          , Uh          , Uh          , Uh          , Uh          , Cud         , Xu          
Xu          , Iwr         , Iwr         , Iwr         , Iwr         , Iwr         , Iwr         , Iwr         , Iwr         , Iwr         , Iwr         , Iwr         , Iwr         , Iwr         , Iwr         , Iwr         , Iwr         , Iwr         , Iwr         , Xu          , Xu          , Uh          , Ur          , Uh          , Uh          , Uh          , Ur          , Uu          , Ur          , Ur          , Ur          , Uh          , Uh          , Ur          , Uh          , Ur          , Ur          , Ur          , Ur          , Ur          , Uh          , Ur          , Ur          , Ur          , Uh          , Kud         , Xu          
Xu          , Iwr         , Iwr^Vhc     , Xos         , Iwr^Vhc     , Xos         , Iwr^Vhc     , Xos         , Iwr^Vhc     , Xos         , Iwr^Vhc     , Xos         , Iwr^Vhc     , Xos         , Iwr^Vhc     , Xos         , Iwr^Vhc     , Xos         , Iwr^Vhc     , Xos         , Xu          , Uh          , Uh^Dr       , Ur          , Ur          , Xos         , Uh          , Uh          , Uh          , Uu          , Uh          , Ur          , Uh          , Xos         , Uh          , Uh          , Uh          , Uu          , Uh          , Uh          , Uh          , Xos         , Xu          , Xu          , Xu          , Xu          , Xu          
Xu          , Xu          , Xu          , Xu          , Xu          , Xu          , Xu          , Xu          , Xu          , Xu          , Xu          , Xu          , Xu          , Xu          , Xu          , Xu          , Xu          , Xu          , Xu          , Xu          , Xu          , Xu          , Xu          , Xu          , Xu          , Xu          , Xu          , Xu          , Xu          , Xu          , Xu          , Xu          , Xu          , Xu          , Xu          , Xu          , Xu          , Xu          , Xu          , Xu          , Xu          , Xu          , Xu          , Xu          , Xu          , Xu          , Xu          
