border_size=1
usage=map

Rd^Uf       , Rd^Uf       , Rd^Uf       , Rd          , Rd          , Ss          , Ss          , Ss^Uf       , Gg          , Ss          , Ss          , Ww          , Ww          , Ss          , Ss          , Ss          , Re          
Re          , Rd^Uf       , Rd^Emf      , Rd^Uf       , Rd^Uf       , Ss          , Ss          , Gg^Uf       , Ss          , Gg          , Ss          , Ss          , Ww^Ewf      , Ss          , Ss          , Ss          , Re          
Re^Uf       , Re          , Re          , Gs^Vht      , Gs^Uf       , Gg          , Gg          , Ss          , Ss          , Ss          , Gs^Vht      , 1 Ss        , Ww          , Ss          , Ss          , Re          , Ss          
Rd^Uf       , Rd^Uf       , Rd^Uf       , Re          , Re          , Gg          , Rd          , Gg          , Gg          , Ss          , Gg          , Wwf         , Re          , Ss          , Ww          , Ss          , Ss          
Hh          , Hh          , Hh^Fdw      , Rd^Uf       , Rd          , Re          , Re          , Rd          , Re          , Gg          , Re          , Re          , Wwf         , Wwf         , Ss          , Ww^Ewl      , Ww          
Hh          , Hh          , Rd^Emf      , Rd^Uf       , Rd^Uf       , Rd          , Rd^Emf      , Re          , Rd          , Re          , Gg          , Gg          , Ss          , Ss          , Ss          , Ss          , Ww          
Rd^Uf       , Hh^Fdw      , Rd^Uf       , Rd^Uf       , Hh^Fdw      , Hh^Fdw      , Rd^Uf       , Re          , Rd          , Rd          , Rd          , Gg          , Wwf         , Ss          , Wwf         , Ss          , Ss          
Rd^Uf       , Rd^Uf       , Rd^Emf      , Hh^Fdw      , Hh^Fdw      , Hh^Fdw      , Rd^Uf       , Re          , Re          , Rd          , Gg^Efm      , Gg          , Ss          , Ss          , Wwf         , Ss          , Ss          
Hh          , Hh          , Hh^Fdw      , Hh^Fdw      , Hh^Fdw      , Hh^Fdw      , Rd^Emf      , Gs^Emf      , Re          , Gg^Efm      , Gs^Emf      , Gg          , Wwf         , Ss          , Ss          , Ss          , Ww          
Hh          , Hh          , Hh          , Hh^Fdw      , Rd^Uf       , Rd^Emf      , Gs^Vht      , Rd^Emf      , Re          , Gg^Emf      , Gs^Emf      , Gg          , Gg          , Ss          , Ss          , Ss^Uf       , Ww          
Hh          , Hh          , Hh          , Rd^Uf       , Rd^Uf       , Rd^Uf       , Rd^Uf       , Rd^Uf       , Re          , Gg^Emf      , Gs^Uf       , Gg          , Gg          , Ss          , Ss          , Ss          , Ww          
Hh          , Hh          , Hh          , Rd^Uf       , Rd^Uf       , Rd^Uf       , Rd^Uf       , Rd^Uf       , Re          , Gg^Uf       , Gs^Uf       , Gg          , Gg          , Ss          , Ss          , Ss          , Ww          
Gg          , Gg          , Gg          , Gg          , Gg          , Gg          , Gg          , Gg          , Gg          , Gg          , Gg          , Gg          , Gg          , Gg          , Gg          , Gg          , Gg          
Gg          , Gg          , Gg          , Gg          , Gg          , Gg          , Gg          , Gg          , Gg          , Gg          , Gg          , Gg          , Gg          , Gg          , Gg          , Gg          , Gg          
Gg          , Gg          , Gg          , Gg          , Gg          , Gg          , Gg          , Gg          , Gg          , Gg          , Gg          , Gg          , Gg          , Gg          , Gg          , Gg          , Gg          
