border_size=1
usage=map

Ww          , Gs^Fp       , Ss          , Ss          , Ss          , Ss          , Ss          , Ss          , Ss          , Gg          , Rb          , Gs          , Gs          , Gs          , Gs^Efm      , Hh^Fdw      , Hh^Fdw      , Hh^Fdw      , Ss          , Ss          , Ss          , Ss          , Ss          , Ss          , Ss          , Hh^Fdw      , Hh^Fdw      , Ss          
Ww          , Ww          , Ww          , Ww^Ewf      , Ww^Ewf      , Ss          , Ss          , Ss          , Gs          , Gd^Vhr      , Rb          , Gs          , Gs          , Gs^Efm      , Gs^Efm      , Hh^Fdw      , Hh          , Hh^Fdw      , Hh^Fdw      , Hh^Fdw      , Hh^Fdw      , Ss          , Ss          , Ss          , Ss          , Hh^Fdw      , Ss          , Ss          
Ww          , Ww^Vm       , Ww          , Ww          , Ww^Ewf      , Ss          , Ss          , Ss          , Ss          , Gs          , Gs          , Rb          , Rb          , Gs          , Gs          , Gs^Efm      , Hh          , Hh          , Hh          , Hh^Fdw      , Ss          , Ss          , Ss          , Ss          , Ss          , Ss          , Ss          , Hh^Fdw      
Ss          , Ww^Ewf      , Ww^Ewf      , Ww^Ewf      , Ss          , Ss^Uf       , Ss^Uf       , Ss^Uf       , Hh^Fdw      , Hh^Fdw      , Hh^Fdw      , Gs          , Rb          , Gs          , Gs          , Gs          , Hh^Fdw      , Hh^Fdw      , Hh^Fdw      , Hh          , Hh^Emf      , Ss          , Ss          , Ss          , Ss          , Ss          , Hh^Fdw      , Ss          
Ss          , Ss          , Ss          , Ss          , Ss^Uf       , Hh^Emf      , Hh^Emf      , Hh^Emf      , Hh^Fdw      , Hh^Fdw      , Hh^Fdw      , Gs          , Rb          , Gs          , Ss          , Hh          , Hh^Fdw      , Hh          , Hh^Fdw      , Hh^Fdw      , Hh^Fdw      , Hh          , Chs         , Chs         , Chs         , Hh^Fdw      , Ss          , Ss          
Ss          , Ss          , Ss          , Ss          , Ss          , Hh^Emf      , Hh^Fdw      , Hh^Fdw      , Hh^Fdw      , Hh^Fdw      , Ss          , Gs          , Rb          , Gs          , Ss          , Ss          , Ss          , Hh          , Hh          , Hh^Fdw      , Hh^Fdw      , Hh          , Chs         , Khw         , Chs         , Hh^Fdw      , Hh^Fdw      , Hh^Fdw      
Ss          , Ss          , Ss          , Ss          , Ss          , Hh^Fdw      , Hh^Fdw      , Hh^Fdw      , Hh^Fdw      , Ss          , Ss          , Gs          , Rb          , Ss          , Ss          , Ss          , Ss          , Ss          , Hh^Fdw      , Hh          , Hh          , Hh^Fdw      , Hh^Fdw      , Chs         , Hh          , Hh^Fdw      , Hh^Fdw      , Hh^Fdw      
Ss          , Ss          , Ss          , Ss          , Ss          , Hh^Fdw      , Ss          , Ss          , Ss          , Ss          , Ss          , Ss          , Rb          , Ss          , Ss          , Ss          , Ss          , Ss          , Ss          , Ss          , Ss          , Gs^Vht      , Ss          , Hh^Fdw      , Hh          , Hh^Fdw      , Hh^Fdw      , Hh^Fdw      
Ss          , Ss          , Ss          , Ss          , Ss          , Hh          , Hh          , Ss          , Ss          , Ss          , Ss          , Ss          , Ss          , Ss          , Ss          , Ss          , Ss          , Ss          , Ss          , Ss          , Ss          , Ss          , Ss          , Ss          , Hh          , Hh^Fdw      , Hh^Fdw      , Hh^Fdw      
Ss          , Ss          , Ss          , Ss          , Ss          , Ss          , Hh^Fdw      , Hh^Fdw      , Hh^Uf       , Ss          , Ss          , Ss          , Ss          , 1 Ss        , Ss          , Ss          , Ss          , Ss          , Ss          , Ss          , Ss          , Ss          , Ss          , Hh^Fdw      , Hh^Fdw      , Hh^Fdw      , Hh^Fdw      , Hh^Fdw      
Ss          , Ss          , Ss          , Ss          , Hh^Fdw      , Hh^Fdw      , Ww          , Hh^Fdw      , Hh          , Hh          , Hh^Fmf      , Hh          , Hh          , Ss          , Ss          , Ss          , Ss          , Ss          , Ss          , Ss          , Ss          , Ss          , Hh          , Hh          , Hh^Fdw      , Hh^Fdw      , Ss          , Ss          
Ss          , Ss          , Ss          , Ss          , Hh^Fdw      , Ww          , Ww^Vm       , Ww          , Ww          , Hh^Fp       , Ww          , Ww          , Ss          , Ww          , Ww          , Ss          , Ss          , Ss          , Ss          , Ss          , Hh^Fdw      , Hh          , Ss          , Hh^Fdw      , Ss          , Ss          , Ss          , Ss          
Ww          , Ss          , Ss          , Ss          , Hh^Fdw      , Ww          , Ww          , Ww          , Gg^Emf      , Ww          , Hh^Fdw      , Ww          , Ww          , Ww          , Ww          , Ss          , Ss          , Ss          , Ss          , Hh          , Hh          , Ss          , Gs^Vht      , Ss          , Ss          , Ss          , Ss          , Ss          
Ss          , Ww          , Ww          , Ss          , Ww          , Ss          , Ww          , Ww^Ewf      , Ww          , Hh          , Hh^Fdw      , Mm          , Ww          , Ww          , Hh^Fdw      , Ss          , Ss          , Ss          , Ss          , Hh^Fdw      , Ss          , Ss          , Ss          , Ss          , Ss^Uf       , Ss^Uf       , Ss^Uf       , Ss          
Ss          , Ss          , Ss          , Ww          , Ss          , Ss          , Ww          , Hh          , Hh          , Hh          , Hh^Fdw      , Hh^Fdw      , Ww          , Hh          , Hh          , Ss          , Ss          , Ss          , Hh          , Hh          , Ss          , Ss          , Ss          , Ss^Uf       , Ss^Uf       , Ss^Uf       , Ss^Uf       , Ss          
Ss          , Ss          , Ss          , Ss          , Hh          , Ss          , Ss          , Ww          , Ww          , Ss^Vhs      , Ww          , Ww          , Ww          , Hh^Fdw      , Hh^Fdw      , Hh          , Hh          , Hh          , Hh^Fdw      , Hh          , Ss          , Hh^Fdw      , Ss          , Ss^Uf       , Ss^Uf       , Ss^Uf       , Ss          , Ss          
Ss          , Ss          , Ss          , Hh          , Ss          , Ss          , Ss          , Hh^Fdw      , Ww          , Hh^Fdw      , Hh^Fdw      , Ww          , Hh^Fdw      , Hh^Fdw      , Hh^Fdw      , Hh^Fdw      , Hh^Fdw      , Re^Vct      , Hh          , Hh^Fdw      , Hh^Fdw      , Hh^Fdw      , Ss          , Ss          , Ss          , Ss          , Ss          , Ss          
Ss          , Ss          , Ss          , Ss          , Ss          , Ss          , Ss          , Ss          , Ss          , Ww          , Hh^Fdw      , Ww          , Ww          , Ww          , Hh          , Hh^Fdw      , Hh^Fdw      , Hh^Fdw      , Ww          , Hh          , Hh^Fdw      , Hh          , Ss          , Ss          , Ss          , Ss          , Ss          , Hh^Fdw      
Ss          , Ss          , Ss          , Ss          , Ss          , Ss          , Ss          , Ss          , Ss          , Ss          , Hh^Fdw      , Ww          , Ww          , Ww          , Hh^Fdw      , Ww          , Ss          , Ss          , Ss          , Hh          , Hh          , Hh^Fdw      , Hh          , Ss          , Ss          , Ss          , Ss          , Hh^Fdw      
Gg          , Gg^Emf      , Gg          , Ww^Vm       , Gs          , Ss          , Ss          , Ss          , Ss          , Ss          , Hh^Fdw      , Hh^Fdw      , Ww          , Hh^Fdw      , Hh^Fdw      , Ww          , Ss          , Ww          , Hh^Fdw      , Hh^Fdw      , Hh          , Ss          , Ss          , Ss          , Ss          , Ss          , Ss          , Ss          
Gg          , Gg          , Gs          , Re          , Ch          , Re          , Ss          , Ss          , Ss          , Ss          , Ss          , Hh^Fdw      , Hh^Fdw      , Hh^Fdw      , Hh^Fdw      , Ss          , Ww          , Hh^Fdw      , Hh          , Hh          , Chr         , Gs^Vht      , Hh          , Hh          , Hh          , Ss          , Ss          , Ss          
Gg          , Gs          , Hh          , Chr         , Khr         , Chr         , Ss          , Ww          , Ww          , Ss          , Ss          , Hh^Fdw      , Hh^Fdw      , Hh^Fdw      , Ww          , Ww          , Ww          , Hh^Fdw      , Hh          , Ch          , Kh          , Ch          , Hh          , Hh          , Hh          , Hh^Fdw      , Hh^Fdw      , Ss          
Ss          , Hh          , Mm          , Chr         , Ch          , Chr         , Ww          , Ww          , Ww          , Ww          , Ss          , Ss          , Ss          , Ww          , Ss          , Ss          , Ww          , Hh^Fdw      , Hh          , Chr         , Ch          , Chr         , Hh          , Hh          , Hh          , Hh          , Ss          , Ss          
Ss          , Ss          , Hh          , Hh          , Ss          , Ss          , Ww          , Ww          , Ww          , Ww          , Ss          , Ss^Vhs      , Ss          , Ss          , Ss          , Ss          , Ww          , Hh^Fdw      , Hh^Fdw      , Hh          , Hh          , Hh          , Hh          , Hh          , Hh          , Hh^Emf      , Ss          , Ss          
Ss          , Ss          , Ww^Vm       , Ss          , Ss          , Ss          , Ww          , Ww          , Ww          , Ss          , Gs^Fp       , Gs^Fp       , Ss          , Ss          , Ss          , Ss          , Ww          , Hh^Fdw      , Hh^Vc       , Hh^Fdw      , Hh^Fdw      , Hh^Fdw      , Ss          , Ss          , Hh          , Gs          , Gg          , Gg          
Ss          , Ss          , Ss          , Gs^Fp       , Ss          , Ss          , Ss          , Ss          , Ss          , Ss          , Gs^Fp       , Gs^Fp       , Gs^Fp       , Ss          , Ss          , Ss          , Ww          , Ww          , Hh^Fdw      , Hh^Fdw      , Hh^Fdw      , Hh^Fdw      , Ss          , Ss          , Hh          , Hh          , Gg          , Ww          
Ss          , Ss          , Ss          , Ss          , Ss          , Ss          , Gs^Fp       , Gs^Fp       , Gs^Fp       , Gs^Fp       , Gs^Fp       , Gs^Fp       , Gs^Fp       , Ss          , Ss          , Ss          , Ww          , Hh^Fdw      , Hh^Fdw      , Hh^Fdw      , Hh^Fdw      , Hh^Fdw      , Ss          , Ss          , Ss          , Hh          , Hh          , Ss          
