border_size=1
usage=map

Gs^Fp       , Gs^Fp       , Gs^Fp       , Gs^Fp       , Gs^Fp       , Gs^Fp       , Gs^Fp       , Gs^Fp       , Gs^Fp       , Gs^Fp       , Ss          , Ss          , Ww          , Ww          , Ss          , Ss          , Ss          , Ss          , Ss          , Ss          , Ss          , Ww          , Ww          , Ss          , Ss          , Ss          , Ss          
Gs^Fp       , Hh^Fdf      , Re          , Gs^Fp       , Re          , Gs^Fp       , Ss^Vhs      , Re          , Gg          , Gs^Fp       , Ss          , Ss          , Ww          , Ww          , Uu^Uf       , Uu^Uf       , Ss          , Ss          , Ss          , Ss          , Ss          , Ww          , Ww          , Ss          , Ss          , Ss          , Ss          
Re          , Re          , Re          , Re          , Chr         , Re          , Re          , Re          , Ss          , Ss          , Ww          , Ww          , Ss          , Ss          , Ss          , Ww          , Ww          , Ss          , Ss          , Ss          , Ss          , Ss          , Ss          , Ww          , Ss          , Ss          , Ss          
Re          , Re          , Gg          , Chr         , Khr         , Chs         , Gg          , Ss          , Ss          , Ss          , Ww          , Ss          , Ss          , Ss^Vhs      , Gg          , Ss          , Ww          , Ss          , Ss          , Ss          , Ss          , Ss          , Ss          , Ww          , Ww          , Ss          , Ss          
Ss          , Ss          , Gg          , Chs         , Chr         , Chr         , Ss          , Gg^Vl       , Ss          , Ss          , Ss          , Ss          , Gg          , Gg          , Gg          , Ss          , Ww          , Ss          , Ss          , Ss          , Gg          , Gg          , Ss          , Ss          , Ss          , Ww          , Ww          
Ss          , Ss          , Ss          , Gg          , Gg          , Gg          , Gg          , Ww          , Wwf         , Ww          , Gg          , Ss          , Gg          , Re          , Re          , Gg          , Wwf         , Gg          , Gg          , Ss          , Ss          , Gg          , Gg          , Ss          , Ss^Vm       , Ss          , Ss          
Ww          , Ww          , Ww          , Gg^Vl       , Gg          , Ww          , Ww          , Wwf         , Gg          , Gg          , Re          , Gg          , Gg          , Re          , Gg          , Gg          , Ww          , Gg          , Gg          , Ss^Vm       , Ss          , Ss          , Ss          , Ss          , Gg          , Gg          , Gg          
Ss          , Ss          , Gg          , Ww          , Gg          , Gg          , Ss          , Ww          , Ss          , Gg          , Gg          , Gg          , Ss          , Gg          , Ss          , Ss          , Ss          , Ss          , Ss          , Gg          , Ss          , Ss          , Ss          , Gg          , Gg          , Gg          , Re          
Ss          , Ss          , Ww          , Ww          , Ss          , Ss          , Ss          , Ww          , Ww          , Ss          , Gg          , Gg          , Ss          , Ss          , Ss          , Ww          , Ss          , Ss          , Gg          , Uu^Uf       , Ss          , Gg          , Ss          , Ss          , Gg          , Re          , Gg          
Ss          , Ss          , Ss          , Ww          , Ww          , Ss          , Ss          , Ss          , Ww          , Ss          , Gg          , Ss          , Ss^Vhs      , Ss          , Ss          , Ww          , Ss          , Ss          , Ss          , Gg          , Ss          , Ss          , Ss          , Ss          , Ss          , Re          , Ss          
Gg          , Gg          , Ss          , Ss          , Ss          , Ww          , Ww          , Ww          , Ss          , Ww          , Wwf         , Gg          , Ss          , Ss          , Ww          , Ww          , Ww          , Ss          , Ss          , Ss          , Ss          , Ss^Vm       , Gg          , Gg          , Re          , Re          , Ss          
Ss          , Ss          , Gg          , Ss          , Gg          , Ss          , Ss          , Ww          , Ss          , 1 Gg        , Ss          , Ww          , Ww          , Ww          , Ss          , Ss          , Ss          , Ss          , Ss          , Ss          , Ss          , Gg          , Gs^Fp       , Re          , Gs^Fp       , Gg          , Ss          
Ss          , Ss          , Ss          , Ss          , Gg          , Gg          , Ss          , Ww          , Ss          , Gg          , Gg          , Gg          , Gg          , Ww          , Ss          , Ss          , Ss          , Ww          , Ss          , Ss          , Gg          , Gg          , Gs^Fp       , Re          , Gs^Fp       , Gs^Fp       , Gg          
Gg          , Gg          , Ss^Vhs      , Ss          , Ss          , Ss          , Ss          , Ww          , Ss          , Gg          , Ss^Vhs      , Gg          , Gg          , Ww          , Ss          , Wwf         , Ss          , Ss          , Ss          , Gg          , Re          , Re          , Re          , Re          , Gs^Fp       , Gs^Fp       , Gs^Fp       
Gg          , Gg          , Ss          , Ss          , Ss          , Ss          , Ww          , Ww          , Ss          , Ss          , Ss          , Gg          , Wwf         , Ww          , Ko          , Ss          , Ss          , Ko          , Ss          , Ss          , Ww          , Gg          , Gg          , Gg          , Gg          , Gs^Fp       , Gg          
Gg          , Gg          , Gg          , Gg          , Ss          , Ww          , Ww          , Ww          , Ss          , Ww          , Ss          , Ss          , Ss          , Ww          , Ss          , Ss          , Re          , Re          , Khr         , Ko          , Ss          , Ww          , Ss          , Ss^Vhs      , Ss          , Gg          , Ss          
Gs^Fp       , Gs^Fp       , Gs^Fp       , Gg          , Gg          , Ww          , Ww          , Ww          , Gg          , Ss          , Ss          , Ww          , Ww          , Ss          , Ss          , Ss          , Re          , Hh          , Hh^Vo       , Hh          , Ko          , Ss          , Ww          , Ss          , Ss          , Ss          , Ss          
Gs^Fp       , Gs^Fp       , Gg          , Gs^Fp       , Gg          , Ww          , Ww          , Ww          , Ss          , Gg          , Ss          , Ss          , Ww          , Ss          , Ko          , Ss          , Re          , Hh          , Ss          , Hh          , Ss          , Ss          , Ss          , Ss          , Ww          , Ww          , Ss          
Re          , Re          , Re          , Gg^Vo       , Gs^Fp       , Gg          , Gg          , Ww          , Ss          , Ss          , Gg^Vo       , Ss          , Ww          , Ss          , Ss          , Re          , Ss          , Ss          , Ss          , Ko          , Ss          , Ss          , Ww          , Ww          , Ss          , Ss          , Ss          
Gg          , Gg          , Gg          , Re          , Re          , Gg          , Gs^Fp       , Gg          , Gg          , Ss          , Gg          , Wwf         , Re          , Ss          , Ww          , Ss          , Ss          , Ss^Vm       , Ss          , Re          , Ss          , Ss          , Ww          , Ss          , Wwf         , Ss^Vm       , Ss          
Hh          , Hh          , Hh^Fdw      , Gg          , Gs^Fp       , Re          , Re          , Gs^Fp       , Re          , Gg          , Re          , Re          , Wwf         , Wwf         , Ss          , Ww          , Ww          , Re          , Re          , Re          , Re          , Ww          , Ss          , Ss          , Re          , Re          , Re          
Hh          , Hh          , Gg          , Gg          , Gg          , Gs^Fp       , Gg          , Re          , Gs^Fp       , Re          , Gg          , Gg          , Ss          , Ss          , Ss          , Ss          , Ww          , Ss          , Ss          , Re          , Re          , Re          , Re          , Ss          , Ss          , Ss          , Ss          
Gg          , Hh^Fdw      , Gg          , Gg          , Hh^Fdw      , Hh^Fdw      , Gg          , Re          , Gs^Fp       , Gs^Fp       , Gs^Fp       , Gg          , Wwf         , Ss          , Wwf         , Ss          , Ss          , Ww          , Ww          , Ww          , Ss          , Re          , Re          , Re          , Ss          , Re          , Ss          
Gg          , Gg          , Gg          , Hh^Fdw      , Hh^Fdw      , Hh^Fdw      , Gg          , Re          , Re          , Gs^Fp       , Gg          , Gg          , Ss          , Ss          , Wwf         , Ss          , Ss          , Ww          , Wo          , Ww          , Wwf         , Ss          , Re          , Re          , Re          , Ss          , Ss          
Hh          , Hh          , Hh^Fdw      , Hh^Fdw      , Hh^Fdw      , Hh^Fdw      , Gg          , Gs^Fp       , Re          , Gg          , Gs^Fp       , Gg          , Wwf         , Ss          , Ss          , Ss          , Ww          , Ww          , Ww          , Wwf         , Ss          , Ss          , Chs         , Chs         , Chr         , Ss          , Gg          
Hh          , Hh          , Hh          , Hh^Fdw      , Gg          , Gg          , Gg^Vo       , Gg          , Re          , Gg          , Gs^Fp       , Gg          , Gg          , Ss          , Ss          , Ss          , Ww          , Wo          , Ww          , Ss          , Ss          , Chr         , Chw         , Khs^Cov     , Chw         , Chs         , Gg          
Hh          , Hh          , Hh          , Gg          , Gg          , Gg          , Gg          , Gg          , Re          , Gg          , Gs^Fp       , Gg          , Gg          , Ss          , Ss          , Ss          , Ww          , Wo          , Ww          , Ss          , Ss          , Ss          , Ss          , Ss          , Gg          , Ss          , Gg          
