border_size=1
usage=map

Gs^Fp       , Gs^Fp       , Gs^Fp       , Gs^Fp       , Gs^Fp       , Gs^Fp       , Gs^Fp       , Hh          , Hh          , Wo          , Hh^Fp       , Hh^Fp       , Hh^Fp       , Hh^Fp       , Hh^Fp       , Ss          , Ww          , Gs^Ft       , Gs^Ft       , Gs^Ft       , Gs^Ft       , Gs^Ft       , Gs^Ft       , Gs^Ft       , Ss          , Ww          , Hh^Fmf      , Hh^Fmw      , Hh^Fmw      , Hh^Fmw      , Hh^Fmw      , Hh^Fmw      , Hh^Fmw      , Hh^Fmw      , Hh^Fmw      , Hh^Fmw      , Hh^Fmw      
Gs^Fp       , Gs^Fp       , Hh^Fdw      , Hh^Fdw      , Hh^Fdw      , Hh^Fdw      , Hh          , Hh          , Hh^Fdw      , Wo          , Hh^Fp       , Hh^Fp       , Hh^Fp       , Hh^Fp       , Hh^Fp       , Ss          , Ss          , Ww          , Ww          , Gs^Ft       , Gs^Ft       , Gs^Ft       , Gs^Ft       , Ss          , Ww          , Ww          , Chw         , Hh^Fmw      , Hh^Fmw      , Hh^Fmw      , Ww          , Hh^Fmw      , Chs         , Chs         , Chs         , Hh^Fmw      , Hh^Fmw      
Gs^Fp       , Gs^Fp       , Wo          , Hh^Fdw      , Chs         , Hh^Fdw      , Hh          , Hh          , Hh          , Wo          , Hh^Fp       , Hh^Fp       , Hh^Fp       , Hh^Fp       , Hh^Fp       , Hh^Fp       , Hh^Fp       , Ss          , Ww          , Gs^Ft       , Gs^Ft       , Gs^Ft       , Ss          , Ss          , Ww          , Chw         , 4 Khs       , Hh^Fmw      , Ww          , Ww          , Ss          , Ww          , Chw         , Kv          , Chs         , Hh^Fmw      , Hh^Fmw      
Gs^Fp       , Gs^Fp       , Hh^Fdw      , Chw         , Khs         , Ch          , Hh          , Hh^Fdw      , Hh          , Wo          , Wo          , Hh^Fp       , Hh^Fp       , Hh^Fp       , Hh^Fp       , Hh^Fp       , Hh^Fp       , Ss          , Ss          , Ww          , Gs^Ft       , Gs^Ft       , Ss          , Ww          , Hh^Fdf      , Chw         , Hh^Fmw      , Hh^Fmw      , Ww          , Ss          , Hh^Fmw      , Ss          , Hh^Fmw      , Chs         , Re          , Hh^Fmw      , Re          
Gs^Fp       , Gs^Fp       , Hh^Fdw      , Chs         , Ch          , Chr         , Hh          , Hh          , Hh          , Hh          , Wo^Bw\      , Hh^Fp       , Hh^Fp       , Hh^Fp       , Hh^Fp       , Hh^Fp       , Ss          , Ss          , Ww          , Ww          , Gs^Ft       , Ss          , Ww          , Ww          , Ww          , Hh^Fmf      , Ww          , Ww          , Ss          , Ss          , Hh^Fmw      , Hh^Fmw      , Hh^Fmw      , Re          , 1 Hh^Fmw    , Re          , Hh^Fmw      
Gs^Fp       , Gs^Fp       , Gs^Fp       , Hh^Fdw      , Hh^Fdw      , Re          , Hh          , Hh          , Hh          , Wo          , Hh^Fp       , Hh^Fp       , Hh^Fp       , Hh^Fp       , Hh^Fp       , Hh^Fp       , Ss          , Ww          , Gs^Ft       , Gs^Ft       , Ss          , Ww          , Ss          , Ss          , Ss          , Ww          , Ss          , Ss          , Hh^Fmw      , Hh^Fmw      , Hh^Fmw      , Hh^Fmw      , Hh^Fdw      , Hh^Fmw      , Hh^Fmw      , Hh^Fmw      , Hh^Fmw      
Gs^Fp       , Gs^Fp       , Gs^Fp       , Hh^Fdw      , Re          , Re          , Hh^Fdw      , Hh^Fdw      , Hh          , Wo          , Hh^Fp       , Hh^Fp       , Hh          , Hh^Fp       , Ss          , Ss          , Ww          , Ww          , Gs^Ft       , Gs^Ft       , Ss          , Ww          , Ss          , Hh^Fmw      , Hh^Fmw      , Ss          , Hh^Fmw      , Hh^Fmw      , Hh^Fdw      , Hh^Fdw      , Hh^Fdw      , Hh^Fmw      , Hh          , Hh^Fmw      , Hh^Fmw      , Hh^Fmw      , Hh^Fmw      
Gs^Fp       , Gs^Fp       , Gs^Fp       , Gs^Fp       , Re          , Hh^Fdw      , Hh^Fp       , Hh^Fdw      , Wo          , Wo          , Hh^Fp       , Hh^Fp       , Hh^Fp       , Hh^Fp       , Ss          , Ww          , Gs^Ft       , Gs^Ft       , Gs^Ft       , Gs^Ft       , Ss          , Ww          , Ww          , Hh^Fmw      , Hh^Fmw      , Hh^Fmw      , Hh^Fdw      , Hh^Fdw      , Hh^Fdw      , Hh^Fdw      , Hh^Fmw      , Hh          , Hh^Fmw      , Hh          , Hh          , Hh^Fdw      , Hh^Fmw      
Gs^Fp       , Gs^Fp       , Gs^Fp       , Re          , Re          , Gs^Fp       , Gs^Fp       , Gs^Fp       , Wo          , Hh^Fp       , Hh^Fp       , Hh^Fp       , Hh^Fp       , Ss          , Ww          , Ww          , Gs^Ft       , Gs^Ft       , Gs^Ft       , Gs^Ft       , Ss          , Ww          , Hh^Fmw      , Hh^Fmw      , Hh^Fdw      , Hh^Fdw      , Hh^Fdw      , Hh^Fdw      , Hh^Fdw      , Hh^Fdw      , Hh^Fdw      , Hh          , Hh          , Hh^Fmw      , Hh^Fmw      , Hh^Fdw      , Hh^Fmw      
Gs^Fp       , Gs^Fp       , Gs^Fp       , Re          , Gs^Fp       , Gs^Fp       , Gs^Fp       , Gs^Fp       , Wo          , Gs^Fp       , Hh^Fp       , Hh^Fp       , Ss          , Ss          , Ww          , Gs^Ft       , Gs^Ft       , Gs^Ft       , Gs^Ft       , Gs^Ft       , Ss          , Ww          , Ss          , Hh^Fmw      , Hh^Fmw      , Hh^Fmw      , Hh^Fmw      , Hh^Fdw      , Hh^Fdw      , Hh^Fdw      , Hh^Fdw      , Hh^Fdw      , Hh^Fdw      , Hh^Fmw      , Hh          , Hh^Fmw      , Hh          
Gs^Fp       , Gs^Fp       , Gs^Fp       , Re          , Re          , Gs^Fp       , Gs^Fp       , Wo          , Wo          , Gs^Fp       , Ss          , Ss          , Ww          , Ww          , Ss          , Ss          , Ss          , Ss          , Ss          , Ss          , Ss          , Ww          , Ww          , Ss          , Ss          , Ss          , Ss          , Hh^Fmw      , Hh^Fmw      , Hh^Fdw      , Hh^Fdw      , Hh          , Hh          , Hh^Fdw      , Hh^Fdw      , Hh^Fmw      , Hh          
Gs^Fp       , Hh^Fdf      , Re          , Gs^Fp       , Re          , Gs^Fp       , Re          , Re          , Wo          , Gs^Fp       , Ss          , Ss          , Ww          , Ww          , Uu^Emf      , Uu^Emf      , Ss          , Ss          , Ss          , Ss          , Ss          , Ww          , Ww          , Ss          , Ss          , Ss          , Ss          , Hh^Fdw      , Hh^Fmw      , Hh^Fdw      , Hh^Fdw      , Hh^Fdw      , Hh^Fdw      , Hh^Fdw      , Hh          , Hh          , Hh^Fmw      
Re          , Re          , Re          , Re          , Chr         , Re          , Re          , Re          , Ss          , Ss          , Ww          , Ww          , Ss          , Ss          , Ss          , Ww          , Ww          , Ss          , Ss          , Ss          , Ss          , Ss          , Ss          , Ww          , Ss          , Ss          , Ss          , Hh^Fmw      , Hh^Fmw      , Hh          , Hh^Fdw      , Hh          , Hh^Fmw      , Hh^Fmw      , Hh^Fmw      , Hh^Fmw      , Hh^Fmw      
Re          , Re          , Gg          , Chr         , 3 Khr       , Chs         , Gg          , Ss          , Ss          , Ss          , Ww          , Ss          , Ss          , Ss^Vhs      , Gg          , Ss          , Ww          , Ss          , Ss          , Ss          , Ss          , Ss          , Ss          , Ww          , Ww          , Ss          , Ss          , Hh^Fmw      , Hh^Fdw      , Hh^Fdw      , Hh^Fmw      , Hh^Fmw      , Hh          , Hh^Fdw      , Re          , Re          , Hh^Fmw      
Ss          , Ss          , Gg          , Chs         , Chr         , Chr         , Ss          , Ss^Vhs      , Ss          , Ss          , Ss          , Ss          , Gg          , Gg          , Gg          , Ss          , Ww          , Ss          , Ss          , Ss          , Gg^Em       , Gg^Em       , Ss          , Ss          , Ss          , Ww          , Ww          , Ss          , Ss          , Hh^Fmw      , Hh^Fmw      , Hh^Fdw      , Re          , Re          , Hh^Fdw      , Re          , Hh^Fmw      
Ss          , Ss          , Ss          , Gg          , Gg          , Gg          , Gg          , Ww          , Wwf         , Ww          , Gg          , Ss          , Gg          , Re          , Re          , Gg          , Wwf         , Gg          , Gg          , Ss          , Ss          , Gg^Em       , Gg^Em       , Ss          , Ss^Vm       , Ss          , Ss          , Ww          , Ww          , Ss          , Re          , Re          , Hh^Fdw      , Hh^Fdw      , Hh^Fdw      , Hh^Fdw      , Hh^Fmw      
Ww          , Ww          , Ww          , Ss^Vhs      , Gg          , Ww          , Ww          , Wwf         , Gg          , Gg          , Re          , Gg          , Gg          , Re          , Gg          , Gg          , Ww          , Gg          , Gg          , Ss^Vm       , Ss          , Ss          , Ss          , Ss          , Gg          , Gg          , Gg          , Ss          , Re          , Re          , Ww          , Ss          , Ss          , Ss          , Ss          , Hh^Fmw      , Hh^Fmw      
Ss          , Ss          , Gg          , Ww          , Gg          , Gg          , Ss          , Ww          , Ss          , Gg          , Gg          , Gg          , Ss          , Gg          , Ss          , Ss          , Ss          , Ss          , Ss          , Gg^Em       , Ss          , Ss          , Ss          , Gg^Efm      , Gg          , Gg          , Re          , Gg          , Gg          , Ss          , Ss          , Ww          , Ww          , Ww          , Ww          , Ss          , Ss          
Ss          , Ss          , Ww          , Ww          , Ss          , Ss          , Ss          , Ww          , Ww          , Ss          , Gg          , Gg          , Ss          , Ss          , Ss          , Ww          , Ss          , Ss          , Gg^Em       , Uu^Emf      , Ss          , Gg          , Ss          , Ss          , Gg          , Re          , Gg          , Gg          , Gg          , Gg          , Gg^Efm      , Ss          , Ss          , Ww          , Ww          , Ww          , Ww          
Ss          , Ss          , Ss          , Ww          , Ww          , Ss          , Ss          , Ss          , Ww          , Ss          , Gg          , Ss          , Ss          , Ss          , Ss          , Ww          , Ss          , Ss          , Ss          , Gg          , Ss          , Ss          , Ss          , Ss          , Ss          , Re          , Ss          , Ss          , Ss          , Gg^Efm      , Ss          , Ss          , Ww          , Ww          , Ww          , Ww          , Ww          
Gg          , Gg          , Ss          , Ss          , Ss          , Ww          , Ww          , Ww          , Ss          , Ww          , Wwf         , Gg          , Ss          , Ss          , Ww          , Ww          , Ww          , Ss          , Ss          , Ss          , Ss          , Gs^Vht      , Gg          , Gg          , Re          , Re          , Ss          , Ss          , Ss          , Ss          , Ss          , Ww          , Gg          , Gg          , Gg          , Ww          , Ww          
Ss          , Ss          , Gg          , Ss          , Gg          , Ss          , Ss          , Ww          , Ss          , Gg          , Ss          , Ww          , Ww          , Ww          , Ss          , Ss          , Ss          , Ss          , Ss          , Ss          , Ss          , Gg          , Gs^Ft       , Re          , Gs^Ft       , Gg          , Ss          , Ss          , Ss          , Ss          , Ss          , Ss          , Ss          , Ss          , Ss          , Gg          , Gg          
Ss          , Ss          , Ss          , Ss          , Gg          , Gg          , Ss          , Ww          , Ss          , Gg          , Gg          , Gg          , Gg          , Ww          , Ss          , Ss          , Ss          , Ww          , Ss          , Ss          , Gg          , Gg          , Gs^Ft       , Re          , Gs^Ft       , Gs^Ft       , Gs^Fdw      , Ss          , Ss          , Ss          , Ss          , Ss          , Ss          , Ss          , Ss          , Ss          , Ss          
Gg          , Gg          , Gs^Vc       , Ss          , Ss          , Ss          , Ss          , Ww          , Ss          , Gg          , Ss          , Gg          , Gg          , Ww          , Ss          , Wwf         , Ss          , Ss          , Ss          , Gg          , Re          , Re          , Re          , Re          , Gs^Ft       , Gs^Ft       , Gs^Ft       , Gs^Fdw      , Gs^Fdw      , Ss          , Gs^Fdw      , Gg          , Gg          , Ss          , Ss          , Ss          , Ss          
Gg          , Gg          , Ss          , Ss          , Ss          , Ss          , Ww          , Ww          , Ss          , Ss          , Ss          , Gg          , Wwf         , Ww          , Ko          , Ss          , Ss          , Wo          , Ss          , Ss          , Ww          , Gg          , Gg          , Gg          , Gg          , Gs^Ft       , Gg          , Gg          , Ss          , Gs^Fdw      , Ss          , Gs^Fdw      , Ss          , Ss          , Ss          , Ss          , Ss          
Gg          , Gg          , Gg          , Gg          , Ss          , Ww          , Ww          , Ww          , Ss          , Ww          , Ss          , Ss          , Ss          , Ww          , Ss          , Ss          , Re          , 2 Re        , Ss          , Ko^Dr       , Ss          , Ww          , Ss          , Gs^Vht      , Ss          , Gg          , Ss          , Ss          , Ss          , Ss          , Ss          , Ss          , Ss          , Ss          , Ss          , Ss          , Ss          
Gs^Ft       , Gs^Ft       , Gs^Ft       , Gg          , Gg          , Ww          , Ww          , Ww          , Gg          , Ss          , Ss          , Ww          , Ww          , Ss          , Ss          , Ss          , Re          , Hh          , Hh          , Hh          , Hh^Dr       , Ss          , Ww^Ewf      , Ss          , Ss          , Ss          , Ss          , Ss          , Ss          , Ss          , Ss          , Ss          , Ss          , Ss          , Ss          , Ss          , Ss          
Gs^Ft       , Gs^Ft       , Gg          , Gs^Ft       , Gg          , Ww          , Ww          , Ww          , Ss          , Gg          , Ss          , Ss          , Ww          , Ss          , Hh          , Ss          , Re          , Hh          , Ss          , Hh          , Ss          , Ss          , Ss          , Ss          , Ww          , Ww          , Ss          , Ss          , Ss          , Ss          , Ss          , Ss          , Ss          , Ss          , Ss          , Ss          , Ss          
Re          , Re          , Re          , Ggf^Efm     , Gs^Ft       , Gg          , Gg          , Ww          , Ss          , Ss          , Ggf^Efm     , Ss          , Ww          , Ss          , Ss          , Re          , Ss          , Ss          , Ss          , Wo          , Ss          , Ss          , Ww^Ewf      , Ww          , Ss          , Ss          , Ss          , Ss          , Ss          , Ss          , Ss          , Ss          , Ss          , Ss          , Ss          , Ss          , Ss          
Gg          , Gg          , Gg          , Re          , Re          , Gg          , Gs^Ft       , Gg          , Gg          , Ss          , Gg          , Wwf         , Re          , Ss          , Ww          , Ss          , Ss          , Ss^Vm       , Ss          , Re          , Ss          , Ss          , Ww^Ewf      , Ss          , Wwf         , Gs^Vht      , Ss          , Ss          , Ss          , Ss          , Ss          , Ss          , Ss          , Ss          , Ss          , Ss          , Ss          
Hh          , Hh          , Hh^Fdw      , Gg          , Gs^Ft       , Re          , Re          , Gs^Ft       , Re          , Gg          , Re          , Re          , Wwf         , Wwf         , Ss          , Ww          , Ww          , Re          , Re          , Re          , Re          , Ww          , Ss          , Ss          , Re          , Re          , Re          , Ss          , Re          , Ss          , Ss          , Ss          , Re          , Ss          , Ss          , Ss          , Re          
Hh          , Hh          , Gg          , Gg          , Gg          , Gs^Ft       , Gg          , Re          , Gs^Ft       , Re          , Gg          , Gg          , Ss          , Ss          , Ss          , Ss          , Ww^Ewl      , Ss          , Ss          , Re          , Re          , Re          , Re          , Ss          , Ss          , Ss          , Ss          , Re          , Ss          , Re          , Re          , Re          , Re          , Ss          , Re          , Re          , Ss          
Gg          , Hh^Fdw      , Gg          , Gg          , Hh^Fdw      , Hh^Fdw      , Gg          , Re          , Gs^Ft       , Gs^Ft       , Gs^Ft       , Gg          , Wwf         , Ss          , Wwf         , Ss          , Ss          , Ww          , Ww          , Ww          , Ss          , Re          , Re          , Re          , Ss          , Re          , Ss          , Ss          , Ss          , Ss          , Ss          , Ss          , Ss          , Ss          , Ss          , Ss          , Ss          
Gg          , Gg          , Gg          , Hh^Fdw      , Hh^Fdw      , Hh^Fdw      , Gg          , Re          , Re          , Gs^Ft       , Gg          , Gg          , Ss          , Ss          , Wwf         , Ss          , Ss          , Ww^Ewl      , Wo          , Ww          , Wwf         , Ss          , Re          , Re          , Re          , Ss          , Ss          , Ss          , Ss          , Ss          , Ss          , Ss          , Ss          , Ss          , Ss          , Ss          , Ss          
Hh          , Hh          , Hh^Fdw      , Hh^Fdw      , Hh^Fdw      , Hh^Fdw      , Gg          , Gs^Ft       , Re          , Gg          , Gs^Ft       , Gg          , Wwf         , Ss          , Ss          , Ss          , Ww^Ewl      , Ww^Ewl      , Ww          , Wwf         , Ss          , Ss          , Chs         , Chs         , Ss          , Ss          , Ss          , Ss          , Ss          , Ss          , Ss          , Ss          , Ss          , Ss          , Ss          , Ss          , Ss          
Hh          , Hh          , Hh          , Hh^Fdw      , Gg          , Gg          , Gs^Vht      , Gg          , Re          , Gg          , Gs^Ft       , Gg          , Gg          , Ss          , Ss          , Ss          , Ww^Ewl      , Wo          , Ww          , Ss          , Ss          , Chr         , Chw         , Ss          , Chw         , Chs         , Ss          , Ss          , Ss          , Ss          , Ss          , Ss          , Ss          , Ss          , Ss          , Ss          , Ss          
Hh          , Hh          , Hh          , Gg          , Gg          , Gg          , Gg          , Gg          , Re          , Gg          , Gs^Ft       , Gg          , Gg          , Ss          , Ss          , Ss          , Ww^Ewl      , Wo          , Ww          , Ss          , Ss          , Ss          , Ss          , Ss          , Gg          , Ss          , Ss          , Ss          , Ss          , Ss          , Ss          , Ss          , Ss          , Ss          , Ss          , Ss          , Ss          
