border_size=1
usage=map

Gs^Fp       , Gs^Fp       , Gs^Fp       , Gs^Fp       , Gs^Fp       , Gs^Fp       , Gs^Fp       , Gs^Fp       , Gs^Fp       , Gs^Fp       , Ss          , Ss          , Ww          , Ww          , Ss          , Ss          , Ss          , Ss          , Ss          , Ss          , Ss          , Ww          , Ww          , Ss          , Ss          , Ss          , Ss          
Gs^Fp       , Hh^Fdf      , Re          , Gs^Fp       , Re^Es       , Gs^Fp       , Ss^Vhs      , Re          , Gg          , Gs^Fp       , Ss          , Ss          , Ww          , Ww          , Uu^Uf       , Uu^Uf       , Ss          , Ss          , Ss          , Ss          , Ss          , Ww          , Ww          , Ss          , Ss          , Ss          , Ss          
Re          , Re          , Re^Es       , Re          , Chr         , Re          , Re          , Re          , Ss          , Ss          , Ww          , Ww          , Ss          , Ss          , Ss          , Ww          , Ww          , Ss          , Ss          , Ss          , Ss          , Ss          , Ss          , Ww          , Ss          , Ss          , Ss          
Re          , Re          , Gg          , Chr         , Khr         , Chs         , Gg          , Ss          , Ss          , Ss          , Ww          , Ss          , Ss          , Ss^Vhs      , Gg          , Ss          , Ww          , Ss          , Ss          , Ss          , Ss          , Ss          , Ss          , Ww          , Ww          , Ss          , Ss          
Ss          , Ss          , Gg          , Chs         , Chr         , Chr         , Ss          , Ss^Vhs      , Ss          , Ss          , Ss          , Ss          , Gg          , Gg          , Gg          , Ss          , Ww          , Ss          , Ss          , Ss          , Gg          , Gg          , Ss          , Ss          , Ss          , Ww          , Ww          
Ss          , Ss          , Ss          , Gg          , Gg          , Gg          , Gg^Es       , Ww          , Wwf         , Ww          , Gg          , Ss          , Gg          , Re          , Re          , Gg          , Wwf         , Gg          , Gg          , Ss          , Ss          , Gg          , Gg          , Ss          , Ss^Vm       , Ss          , Ss          
Ww          , Ww          , Ww          , Ss^Vhs      , Gg          , Ww          , Ww          , Wwf         , Gg          , Gg          , Re          , Gg          , Gg          , Re          , Gg          , Gg          , Ww          , Gg          , Gg          , Ss^Vm       , Ss          , Ss          , Ss          , Ss          , Gg          , Gg          , Gg          
Ss          , Ss          , Gg          , Ww          , Gg          , Gg          , Ss          , Ww          , Ss          , Gg          , Gg          , Gg^Es       , Ss          , Gg          , Ss          , Ss          , Ss          , Ss          , Ss          , Gg^Em       , Ss          , Ss          , Ss          , Gg          , Gg          , Gg          , Re          
Ss          , Ss          , Ww          , Ww          , Ss          , Ss          , Ss          , Ww          , Ww          , Ss          , Gg          , Gg          , Ss          , Ss          , Ss          , Ww          , Ss          , Ss          , Gg^Em       , Gs^Emf      , Ss          , Gg^Efm      , Ss          , Ss          , Gg          , Re          , Gg          
Ss          , Ss          , Ss          , Ww          , Ww          , Ss          , Ss          , Ss          , Ww          , Ss          , Gg          , Ss          , Gs^Vht      , Ss          , Ss          , Ww          , Ss          , Ss          , Ss          , Gg          , Ss          , Ss          , Ss          , Ss          , Ss          , Re          , Ss          
Gg          , Gg          , Ss          , Ss          , Ss          , Ww          , Ww          , Ww          , Ss          , Ww          , Wwf         , Gg          , Ss          , Ss          , Ww          , Ww          , Ww          , Ss          , Ss          , Ss          , Ss          , Gs^Vht      , Gg          , Gg          , Re          , Re          , Ss          
Ss          , Ss          , Gg          , Ss          , Gg^Es       , Ss          , Ss          , Ww          , Ss          , 1 Gg        , Ss          , Ww          , Ww          , Ww          , Ss          , Ss          , Ss          , Ss          , Ss          , Ss          , Ss          , Gg          , Gs^Ft       , Re          , Gs^Ft       , Gg          , Ss          
Ss          , Ss          , Ss          , Ss          , Gg          , Gg          , Ss          , Ww          , Ss          , Gg          , Gg          , Gg          , Gg          , Ww          , Ss          , Ss          , Ss          , Ww          , Ss          , Ss          , Gg          , Gg          , Gs^Ft       , Re          , Gs^Ft       , Gs^Ft       , Gg          
Gg          , Gg          , Gs^Vc       , Ss          , Ss          , Ss          , Ss          , Ww          , Ss          , Gg          , Gs^Vht      , Gg          , Gg          , Ww          , Ss          , Wwf         , Ss          , Ss          , Ss          , Gg          , Re          , Re          , Re          , Re          , Gs^Ft       , Gs^Ft       , Gs^Ft       
Gg          , Gg          , Ss          , Ss          , Ss          , Ss          , Ww          , Ww          , Ss          , Ss          , Ss          , Gg          , Wwf         , Ww          , Ko          , Ss          , Ss          , Ko          , Ss          , Ss          , Ww          , Gg          , Gg          , Gg          , Gg          , Gs^Ft       , Gg          
Gg          , Gg          , Gg          , Gg          , Ss          , Ww          , Ww          , Ww          , Ss          , Ww          , Ss          , Ss          , Ss          , Ww          , Ss          , Ss          , Re          , Re          , Khr         , Ko          , Ss          , Ww          , Ss          , Gs^Vht      , Ss          , Gg          , Ss          
Gs^Ft       , Gs^Ft       , Gs^Ft       , Gg          , Gg          , Ww          , Ww          , Ww          , Gg          , Ss          , Ss          , Ww          , Ww          , Ss          , Ss          , Ss          , Re          , Hh          , Hh^Vo       , Hh          , Ko          , Ss          , Ww^Ewf      , Ss          , Ss          , Ss          , Ss          
Gs^Ft       , Gs^Ft       , Gg          , Gs^Ft       , Gg          , Ww          , Ww          , Ww          , Ss          , Gg          , Ss          , Ss          , Ww          , Ss          , Ko          , Ss          , Re          , Hh          , Ss          , Hh          , Ss          , Ss          , Ss          , Ss          , Ww          , Ww          , Ss          
Re          , Re          , Re          , Gs^Vht      , Gs^Ft       , Gg          , Gg          , Ww          , Ss          , Ss          , Gs^Vht      , Ss          , Ww          , Ss          , Ss          , Re          , Ss          , Ss          , Ss          , Ko          , Ss          , Ss          , Ww^Ewf      , Ww          , Ss          , Ss          , Ss          
Gg          , Gg          , Gg          , Re          , Re          , Gg          , Gs^Ft       , Gg          , Gg          , Ss          , Gg          , Wwf         , Re          , Ss          , Ww          , Ss          , Ss          , Ss^Vm       , Ss          , Re          , Ss          , Ss          , Ww^Ewf      , Ss          , Wwf         , Gs^Vht      , Ss          
Hh          , Hh          , Hh^Fdw      , Gg          , Gs^Ft       , Re          , Re          , Gs^Ft       , Re          , Gg          , Re          , Re          , Wwf         , Wwf         , Ss          , Ww          , Ww          , Re          , Re          , Re          , Re          , Ww          , Ss          , Ss          , Re          , Re          , Re          
Hh          , Hh          , Gg          , Gg          , Gg          , Gs^Ft       , Gg          , Re          , Gs^Ft       , Re          , Gg          , Gg          , Ss          , Ss          , Ss          , Ss          , Ww^Ewl      , Ss          , Ss          , Re          , Re          , Re          , Re          , Ss          , Ss          , Ss          , Ss          
Gg          , Hh^Fdw      , Gg          , Gg          , Hh^Fdw      , Hh^Fdw      , Gg          , Re          , Gs^Ft       , Gs^Ft       , Gs^Ft       , Gg          , Wwf         , Ss          , Wwf         , Ss          , Ss          , Ww          , Ww          , Ww          , Ss          , Re          , Re          , Re          , Ss          , Re          , Ss          
Gg          , Gg          , Gg          , Hh^Fdw      , Hh^Fdw      , Hh^Fdw      , Gg          , Re          , Re          , Gs^Ft       , Gg          , Gg          , Ss          , Ss          , Wwf         , Ss          , Ss          , Ww^Ewl      , Wo          , Ww          , Wwf         , Ss          , Re          , Re          , Re          , Ss          , Ss          
Hh          , Hh          , Hh^Fdw      , Hh^Fdw      , Hh^Fdw      , Hh^Fdw      , Gg          , Gs^Ft       , Re          , Gg          , Gs^Ft       , Gg          , Wwf         , Ss          , Ss          , Ss          , Ww^Ewl      , Ww^Ewl      , Ww          , Wwf         , Ss          , Ss          , Chs         , Chs         , Chr         , Ss          , Gg          
Hh          , Hh          , Hh          , Hh^Fdw      , Gg          , Gg          , Gs^Vht      , Gg          , Re          , Gg          , Gs^Ft       , Gg          , Gg          , Ss          , Ss          , Ss          , Ww^Ewl      , Wo          , Ww          , Ss          , Ss          , Chr         , Chw         , Khs^Cov     , Chw         , Chs         , Gg          
Hh          , Hh          , Hh          , Gg          , Gg          , Gg          , Gg          , Gg          , Re          , Gg          , Gs^Ft       , Gg          , Gg          , Ss          , Ss          , Ss          , Ww^Ewl      , Wo          , Ww          , Ss          , Ss          , Ss          , Ss          , Ss          , Gg          , Ss          , Gg          
