border_size=1
usage=map

Gs^Fp       , Gs^Fp       , Ss          , Gs^Fp       , Gs^Fp       , Gs^Fp       , Gs^Fp       , Gs^Fp       , Gs^Fp       , Gs^Fp       , Ss          , Hh          , Hh          , Hh          , Hh          , Hh          , Hh          , Ss          , Ss          , Ss          , Ss          , Ww          , Ww^Fp       , Ss^Fp       , Ss^Fp       , Ss^Fp       , Ss^Fp       
Gs^Fp       , Ss          , Ggf         , Ss          , Re          , Ss          , Ss^Vhs      , Ss          , Ggf         , Gs^Fp       , Hh^Fdw      , Hh          , Hh^Fdw      , Hh          , Hh^Vo       , Hh^Uf       , Hh          , Ss          , Ss          , Ss          , Ss          , Ww          , Ww          , Ss^Fp       , Ss^Fp       , Ss^Fp       , Ss^Fp       
Ggf         , Ss          , Ss          , Ss          , Ss          , Ss          , Re          , Ss          , Ss          , Hh          , Hh          , Hh^Fdw      , Hh          , Hh          , Hh          , Hh          , Hh          , Ss          , Ss          , Ss          , Ss^Fp       , Ss          , Ss          , Ww          , Ss^Fp       , Ss^Fp       , Ss^Fp       
Ggf         , Ggf         , Ggf         , Ggf         , Re          , Re          , Ggf         , Ss          , Hh          , Hh          , Hh          , Hh          , Hh          , Hh          , Hh^Fdw      , Hh^Fdw      , Hh          , Ss          , Ss          , Ss          , Ss          , Ss          , Ss          , Ww          , Ww          , Ss^Fp       , Ss^Fp       
Ss          , Ss          , Ggf         , Ggf         , Re          , Re          , Hh          , Hh          , Hh          , Hh^Fdw      , Hh^Fdw      , Hh^Fdw      , Hh^Fdw      , Hh^Fdw      , Hh^Fdw      , Hh          , Hh          , Ss          , Ss          , Ss          , Ggf^Uf      , Ggf^Uf      , Ss          , Ss          , Ss          , Ww          , Ww          
Ss          , Ss          , Ss          , Ww^Vm       , Ggf         , Ggf         , Hh          , Hh          , Hh          , Hh^Fdw      , Hh^Fdw      , Hh^Fdw      , Hh^Fdw      , Hh^Fdw      , Hh^Fdw      , Hh^Fdw      , Ss          , Ggf^Uf      , Ggf^Uf      , Ss          , Ss          , Ggf^Uf      , Ggf^Uf      , Ss          , Ss^Vm       , Ss          , Ss          
Ww          , Ww          , Ww          , Ss          , Ggf         , Ww^Uf       , Ww          , Hh          , Hh          , Hh^Fdw      , Ww          , Ww          , Ss          , Ss          , Ss          , Ss          , Ww          , Ggf^Uf      , Ggf^Uf      , Ss^Vm       , Ss          , Ss          , Ss          , Ss          , Ggf^Uf      , Gg^Uf       , Ggf         
Ss          , Ss          , Gs^Uf       , Ww          , Ss          , Ss          , Ss          , Ww          , Ss          , Hh^Fdw      , Ww          , Ww          , Wwr         , Ww          , Ww          , Ss          , Ss          , Ss          , Ss          , Ggf^Uf      , Ss          , Ss          , Ss          , Ggf^Uf      , Ggf^Uf      , Ggf^Uf      , Re          
Ss          , Ss          , Ww          , Ww          , Ss          , Ss          , Ww          , Ww          , Ww          , Ww          , Ww          , Ww          , Wwr         , Ww          , Ww          , Ww          , Ww          , Ss          , Ggf^Uf      , Ggf         , Ss          , Ggf^Uf      , Ss          , Ss          , Ggf^Uf      , Re          , Ggf^Uf      
Ss          , Ss          , Ss          , Ww          , Ww          , Ww          , Ww          , Ww          , Ww          , Ww          , Wwr         , Wwr         , 1 Hh        , Wwr         , Wwr         , Ww          , Ww          , Ww          , Ww          , Ggf^Uf      , Ss          , Ss          , Ss          , Ss          , Ss          , Re          , Ss          
Rd          , Rd          , Ss          , Ww          , Ss          , Ww          , Ww          , Ww          , Wwr         , Wwr         , Hh          , Hh          , Hh^Uf       , Hh          , Hh          , Wwr         , Wwr         , Ww          , Ww          , Ww          , Ss          , Ss^Vm       , Ggf^Uf      , Ggf^Uf      , Re          , Re          , Ss          
Ss          , Ss^Vhs      , Rd          , Ww          , Ss          , Ww          , Ww          , Ww          , Wwr         , Hh          , Hh^Uf       , Hh^Uf       , Chr         , Hh^Uf       , Hh^Uf       , Wwr         , Wwr         , Ww          , Ww          , Ww          , Ss          , Gg^Uf       , Ggf^Uf      , Re          , Ggf^Uf      , Ggf^Uf      , Ss          
Ss          , Ss          , Ss          , Ww          , Ss          , Ww          , Ww          , Ww          , Wwr         , Hh          , Hh^Uf       , Chr         , Khs         , Hh^Vo       , Hh^Uf       , Hh          , Wwr         , Ww          , Ww          , Ww          , Ggf^Uf      , Ggf^Uf      , Ggf^Uf      , Re          , Ggf^Uf      , Ggf^Uf      , Ggf^Uf      
Rd          , Rd          , Ss          , Ss          , Ss          , Ww          , Ww          , Ww          , Wwr         , Hh          , Hh^Uf       , Hh^Vo       , Chr         , Chr         , Hh^Uf       , Hh          , Wwr         , Ww          , Ww          , Ww          , Re          , Re          , Re          , Re          , Ggf^Uf      , Ggf^Uf      , Ggf^Uf      
Rd          , Rd          , Ss          , Ss          , Ss          , Ww          , Ww          , Ww          , Wwr         , Hh          , Hh          , Hh^Uf       , Hh^Uf       , Hh^Uf       , Hh          , Hh          , Wwr         , Ww          , Ww          , Ww          , Ww          , Ggf^Uf      , Ggf^Uf      , Ggf^Uf      , Ggf^Uf      , Ggf^Uf      , Ggf^Uf      
Rd          , Rd          , Rd          , Rd          , Ss          , Ww          , Ww          , Ww          , Ww          , Wwr         , Wwr         , Hh          , Wwr         , Hh          , Wwr         , Wwr         , Ww          , Ww          , Ww          , Ww          , Ss          , Ww          , Ss          , Ss^Vhs      , Ss          , Ggf^Uf      , Ss          
Rd^Uf       , Rd^Uf       , Rd^Uf       , Rd          , Rd          , Ww          , Ww          , Ww          , Ww          , Ww          , Ww          , Wwr         , Wwr         , Wwr         , Ww          , Ww          , Ww          , Ww          , Ss          , Ss          , Ss          , Ss          , Ww          , Ss          , Ss          , Ss          , Ss          
Re          , Rd^Uf       , Rd^Uf       , Rd^Uf       , Rd^Uf       , Ss          , Ss          , Ww          , Ww          , Ww          , Ww          , Ww          , Ww          , Ww          , Ww          , Ww          , Re          , Hh          , Ss          , Ss          , Ss          , Ss          , Ss          , Ss          , Ww          , Ww          , Ss          
Re^Uf       , Re          , Re          , Gg^Vo       , Gs^Uf       , Gg          , Gg          , Ss          , Ss          , Ww          , Ww          , Ww          , Ww          , Ww          , Ss          , Re          , Ss          , Ss          , Ss          , Ss          , Ss          , Ss          , Chw         , Ww          , Ss          , Ss          , Ss          
Rd^Uf       , Rd^Uf       , Rd^Uf       , Re          , Re          , Gg          , Rd          , Gg          , Gg          , Ss          , Gg          , Ww          , Re          , Ss          , Ww          , Ss          , Ss          , Ss          , Ss          , Ss          , Ss          , Ss          , Khw         , Ss          , Wwf         , Ss          , Ss          
Hh          , Hh          , Hh^Fdw      , Rd^Uf       , Rd          , Re          , Re          , Rd          , Re          , Gg          , Re          , Re          , Wwf         , Wwf         , Ss          , Ww          , Ww          , Ss          , Re          , Wwr         , Ww          , Chw         , Ss          , Chs         , Ww          , Ww          , Ww          
Hh          , Hh          , Rd^Uf       , Rd^Uf       , Rd^Uf       , Rd          , Rd^Uf       , Re          , Rd          , Re          , Gg          , Gg          , Ss          , Ss          , Ss          , Ss          , Ww          , Ss          , Ss          , Ww          , Wwf         , Wwf         , Ss          , Ss          , Ss          , Ss          , Ss          
Rd^Uf       , Hh^Fdw      , Rd^Uf       , Rd^Uf       , Hh^Fdw      , Hh^Fdw      , Rd^Uf       , Re          , Rd          , Rd          , Rd          , Gg          , Wwf         , Ss          , Wwf         , Ss          , Ss          , Ww          , Ww          , Ww          , Ss          , Wwf         , Wwf         , Wwf         , Ss          , Ww          , Ss          
Rd^Uf       , Rd^Uf       , Rd^Uf       , Hh^Fdw      , Hh^Fdw      , Hh^Fdw      , Rd^Uf       , Re          , Re          , Rd          , Gg^Uf       , Gg          , Ss          , Ss          , Wwf         , Ss          , Ss          , Ww          , Wo          , Ww          , Wwf         , Ss          , Wwf         , Wwf         , Ss          , Ss          , Ss          
Hh          , Hh          , Hh^Fdw      , Hh^Fdw      , Hh^Fdw      , Hh^Fdw      , Rd^Uf       , Gs^Uf       , Re          , Gg^Uf       , Gs^Uf       , Gg          , Wwf         , Ss          , Ss          , Ss          , Ww          , Ww          , Ww          , Wwf         , Ss          , Ss          , Ss          , Ss          , Ss          , Ss          , Gg          
