border_size=1
usage=map

Gs^Fp       , Gs^Fp       , Gs^Fp       , Gs^Fp       , Gs^Fp       , Gs^Fp       , Gs^Fp       , Gs^Fp       , Gs^Fp       , Gs^Fp       , Ss          , Ss          , Ww          , Ww          , Ss          , Ss          , Ss          , Ss          , Ss          , Ss          , Ss          , Ww          , Ww^Fp       , Ss^Fp       , Ss^Fp       , Ss^Fp       , Ss^Fp       
Gs^Fp       , Hh^Fdf      , Re          , Gs^Fp       , Re          , Gs^Fp       , Re          , Re          , Gs          , Gs^Fp       , Ss          , Ss          , Ww          , Ww          , Hh^Emf      , Hh^Emf      , Ss^Fp       , Ss          , Ss          , Ss          , Ss          , Ww          , Ww          , Ss^Fp       , Ss^Fp       , Ss^Fp       , Ss^Fp       
Re          , Re          , Re^Uf       , Re          , Ce          , Re          , Re          , Re          , Ss          , Ss          , Ww          , Ww          , Ss          , Ss          , Ss          , Ww          , Ww          , Ss          , Ss          , Ss          , Ss^Fp       , Ss          , Ss          , Ww          , Ss^Fp       , Ss^Fp       , Ss^Fp       
Re          , Re          , Gs          , Ce^Emf      , Ke          , Ce          , Gs          , Ss          , Ss          , Ss          , Ww          , Ss          , Ss          , Hh^Vo       , Hh^Fdw      , Ss          , Ww          , Ss          , Ss          , Ss          , Ss          , Ss          , Ss          , Ww          , Ww          , Ss^Fp       , Ss^Fp       
Ss          , Ss          , Gs          , Ce          , Ce          , Ce          , Ss          , Gs^Vht      , Ss          , Ss          , Ss          , Ss          , Hh^Fdw      , Hh^Fdw      , Hh^Fdw      , Ss          , Ww          , Ss          , Ss          , Ss          , Ggf^Uf      , Ggf^Em      , Ss          , Ss          , Ss          , Ww          , Ww          
Ss          , Ss          , Ss          , Gs          , Gs          , Gs          , 1 Gs        , Ww          , Wwf         , Ww          , Hh^Fdw      , Ss          , Hh^Fdw      , Hh^Fdw      , Hh^Fdw      , Hh^Fdw      , Wwf         , Ggf^Emf     , Ggf^Emf     , Ss          , Ss          , Ggf^Emf     , Ggf^Em      , Ss          , Ss^Vm       , Ss          , Ss          
Ww          , Ww          , Ww          , Ss^Vm       , Gs          , Ww^Uf       , Ww          , Wwf         , Hh          , Hh^Fdw      , Hh^Fdw      , Hh^Fdw      , Hh^Fdw      , Hh^Fdw      , Hh^Fdw      , Hh^Fdw      , Ww          , Ggf^Uf      , Ggf^Emf     , Ss^Vm       , Ss          , Ss          , Ss          , Ss          , Ggf^Em      , Gg^Emf      , Ggf^Efm     
Ss          , Ss          , Gs^Emf      , Ww          , Gs          , Gs          , Ss          , Ww          , Ss          , Hh^Fdw      , Hh^Fdw      , Hh^Fdw      , Ss          , Hh^Fdw      , Ss          , Ss          , Ss          , Ss          , Ss          , Ggf^Em      , Ss          , Ss          , Ss          , Ggf^Emf     , Ggf^Emf     , Ggf^Emf     , Re          
Ss          , Ss          , Ww          , Ww          , Ss          , Ss          , Ss          , Ww          , Ww          , Ss          , Hh^Fdw      , Hh^Fdw      , Ss          , Ss          , Ss          , Ww          , Ss          , Ss          , Ggf^Emf     , Ggf^Efm     , Ss          , Ggf^Emf     , Ss          , Ss          , Ggf^Em      , Re          , Ggf^Uf      
Ss          , Ss          , Ss          , Ww          , Ww          , Ss          , Ss          , Ss          , Ww          , Ss          , Hh^Fdw      , Ss          , Wwr         , Ss          , Ss          , Ww          , Ss          , Ss          , Ss          , Ggf^Uf      , Ss          , Ss          , Ss          , Ss          , Ss          , Re          , Ss          
Rd          , Rd          , Ss          , Ss          , Ss          , Ww          , Ww          , Ww          , Ss          , Ww          , Ww          , Ww          , Wwr         , Ww          , Ww          , Ww          , Ww          , Ss          , Ss          , Ss          , Ss          , Ss^Vm       , Ggf^Uf      , Ggf^Em      , Re          , Re          , Ss          
Ss          , Ss          , Rd          , Ss          , Rd          , Ss          , Ss          , Ww          , Ss          , Ww          , Wwr         , Wwr         , Hh^Emf      , Wwr         , Wwr         , Ww          , Ss          , Ss          , Ss          , Ss          , Ss          , Gg^Emf      , Ggf^Emf     , Re          , Ggf^Emf     , Ggf^Uf      , Ss          
Ss          , Ss          , Ss          , Ss          , Rd^Uf       , Rd^Em       , Ss          , Ss          , Ww          , Ww          , Wwr         , Hh^Emf      , Hh^Vo       , Hh^Emf      , Wwr         , Ww          , Ss          , Ww          , Ss          , Ss          , Ggf^Emf     , Ggf^Em      , Ggf^Emf     , Re          , Ggf^Em      , Ggf^Emf     , Ggf^Uf      
Rd          , Rd          , Ss^Vhs      , Ss          , Ss          , Ss          , Ss          , Ww          , Ss          , Ww          , Wwr         , Hh^Emf      , Hh^Emf      , Hh^Emf      , Wwr         , Ww          , Ss          , Ss          , Ss          , Ggf^Em      , Re          , Re          , Re          , Re          , Ggf^Em      , Ggf^Emf     , Ggf^Uf      
Rd          , Rd          , Ss          , Ss          , Ss          , Ss          , Ww          , Ww          , Ss          , Ww          , Ww          , Wwr         , Wwr         , Wwr         , Ww          , Ww          , Ss          , Ss          , Ss          , Ss          , Ww          , Ggf^Em      , Ggf^Emf     , Ggf^Uf      , Ggf^Em      , Ggf^Em      , Ggf^Uf      
Rd          , Rd          , Rd^Em       , Rd          , Ss          , Ss          , Ggf^Emf     , Ggf^Uf      , Ss          , Ww          , Ss          , Ww          , Ww          , Ww          , Ss          , Ss          , Re          , Re          , Ss          , Ss          , Ss          , Ww          , Ss          , Ss^Vhs      , Ss          , Ggf^Uf      , Ss          
Rd^Uf       , Rd^Uf       , Rd^Uf       , Rd          , Rd^Em       , Ss          , Ss          , Ss^Uf       , Gg          , Ss          , Ss          , Ww          , Ww          , Ss          , Ss          , Ss          , Re          , Hh          , Ss          , Ss          , Ss          , Ss          , Ww          , Ss          , Ss          , Ss          , Ss          
Re          , Rd^Emf      , Rd^Uf       , Rd^Uf       , Rd^Uf       , Ss          , Ss          , Gg^Uf       , Ss          , Gg          , Ss          , Ss          , Ww          , Ss          , Ss          , Ss          , Re          , Hh          , Ss          , Ss          , Ss          , Ss          , Ss          , Ss          , Ww          , Ww          , Ss          
Re^Uf       , Re          , Re          , Gd^Vhr      , Gs^Uf       , Gg          , Gg          , Ss          , Ss          , Ss          , Gg^Vo       , Ss          , Ww          , Ss          , Ss          , Re          , Ss          , Ss          , Ss          , Ss          , Ss          , Ss          , Ww          , Ww          , Ss          , Ss          , Ss          
Rd^Uf       , Rd^Uf       , Rd^Uf       , Re          , Re          , Gg          , Rd          , Gg          , Gg          , Ss          , Gg          , Wwf         , Re          , Ss          , Ww          , Ss          , Ss          , Ss          , Ss          , Ss          , Ss          , Ss          , Ww          , Ss          , Wwf         , Ss          , Ss          
Hh          , Hh          , Hh^Fdw      , Rd^Uf       , Rd          , Re          , Re^Em       , Rd          , Re          , Gg          , Re          , Re          , Wwf         , Wwf         , Ss          , Ww          , Ww          , Ss          , Re          , Wwr         , Ww          , Ww          , Ss          , Ss          , Re          , Re          , Re          
Hh          , Hh          , Rd^Uf       , Rd^Uf       , Rd^Uf       , Rd^Em       , Rd^Uf       , Re^Em       , Rd          , Re          , Gg          , Gg          , Ss          , Ss          , Ss          , Ss          , Ww          , Ss          , Ss          , Re          , Wwf         , Wwf         , Ss          , Ss          , Ss          , Ss          , Ss          
Rd^Uf       , Hh^Fdw      , Rd^Uf       , Rd^Uf       , Hh^Fdw      , Hh^Fdw      , Rd^Uf       , Re^Em       , Rd          , Rd          , Rd^Em       , Gg          , Wwf         , Ss          , Wwf         , Ss          , Ss          , Ww          , Ww          , Ww          , Ss          , Wwf         , Wwf         , Dd^Do       , Re          , Re          , Ss          
Rd^Uf       , Rd^Uf       , Rd^Uf       , Hh^Fdw      , Hh^Fdw      , Hh^Fdw      , Rd^Uf       , Re^Em       , Re          , Rd^Em       , Gg^Uf       , Gg          , Ss          , Ss          , Wwf         , Ss          , Ss          , Ww          , Wo          , Ww          , Wwf^Uf      , Ss          , Hh^Uf       , Dd^Dr       , Hd          , Re          , Ss          
Hh          , Hh          , Hh^Fdw      , Hh^Fdw      , Hh^Fdw      , Hh^Fdw      , Rd^Uf       , Gs^Uf       , Re          , Gg^Uf       , Gs^Uf       , Gg          , Wwf         , Ss          , Ss          , Ss          , Ww          , Ww          , Ww          , Wwf         , Ss          , Hh^Uf       , Chs         , Chs         , Chr         , Hh          , Hh          
Hh          , Hh          , Hh          , Hh^Fdw      , Rd^Uf       , Rd^Uf       , Re^Vct      , Rd^Uf       , Re          , Gg^Uf       , Gs^Uf       , Gg          , Gg          , Ss          , Ss          , Ss^Uf       , Ww          , Wo          , Ww          , Ss          , Ss          , Hh^Uf       , Chw         , 2 Khs^Cov   , Chw         , Hh^Uf       , Hh          
Hh          , Hh          , Hh          , Rd^Uf       , Rd^Emf      , Rd^Emf      , Rd^Emf      , Rd^Uf       , Re          , Gg^Uf       , Gs^Uf       , Gg          , Gg          , Ss          , Ss          , Ss          , Ww          , Wo          , Ww          , Ss          , Hh^Fdw      , Hh^Vc       , Hh^Uf       , Chr         , Hh          , Hh          , Gg          
Hh          , Hh          , Hh          , Rd^Uf       , Rd^Emf      , Rd^Emf      , Rd^Uf       , Rd^Uf       , Re          , Gg^Uf       , Gs^Uf       , Gg          , Gg          , Ss          , Ss          , Ss          , Ww          , Wo          , Ww          , Ss          , Ss          , Ss^Uf       , Ss          , Hh          , Ss^Vm       , Ss          , Gg          
Hh          , Hh          , Hh          , Rd^Uf       , Rd^Uf       , Rd^Uf       , Rd^Uf       , Rd^Uf       , Re          , Gg^Uf       , Gs^Uf       , Gg          , Gg          , Ss          , Ss          , Ss          , Ww          , Wo          , Ww          , Ss          , Ss          , Ss          , Ss          , Ss          , Gg          , Ss          , Gg          
