border_size=1
usage=map

Gs^Fp       , Gs^Fmf      , Ww          , Gs^Fp       , Ss          , Ss          , Ss          , Gg          , Ss          , Ss          , Ss          , Ww          , Ww          , Ww          , Ww          , Ww          , Ww          , Ss          , Ww          , Ss          , Ww          , Ww          , Ww          , Ss          
Gs^Fmf      , Gs^Fp       , Gs^Fp       , Ww          , Ss          , Ss          , Chs^Bw/     , Ss          , Ss          , Ww          , Ss          , Ww          , Ss^Bw/      , Ss^Bw/      , Ss^Bw\      , Re^Bw/      , Ss^Bw\      , Ww          , Ss          , Ss          , Ss^Bw\      , Gg^Wm       , Ss          , Ss          
Gs^Fp       , Gs^Fmf      , Gs^Fp       , Gs^Fp       , Gs^Fmf      , Gs^Vht      , Ss          , Ss^Bw\      , Ss^Bw/      , Ss^Bw\      , Ss^Bw/      , Ss^Bw/      , Ss^Bw/      , Ce          , Ce          , Ce          , Ce          , Ce          , Ss^Bw\      , Ss^Bw/      , Ss^Bw|      , Ss          , Ww          , Ss          
Gs^Fmf      , Gs^Fmf      , Gs^Fp       , Gs^Fp       , Ss          , Ss          , Ss          , Ss          , Ms^Vhha     , Hh^Fdf      , Ss          , Ss^Bw\      , Ss^Bw\      , Ce          , Ce          , Ce          , 1 Ce        , Ce          , Ww          , Ss          , Re          , Ss          , Ss          , Ss          
Gs^Fp       , Gs^Fp       , Gs^Fp       , Gs^Fmf      , Hh^Fdf      , Hh^Fdf      , Hh^Fdf      , Hh^Fdf      , Mm          , Hh^Fdf      , Hh^Fdf      , Ss          , Ce          , Ww^Bw/      , Ce          , Ce          , Ce          , Ss^Bw\      , Ce          , Ss          , Re          , Ss          , Ss          , Ss          
Ss          , Gs^Fmf      , Gs^Fmf      , Hh^Fdf      , Hh^Fdw      , Mm          , Mm          , Mm          , Mm          , Hh^Fdf      , Hh^Fdf      , Ss          , Ss^Bw/      , Ce          , Ce          , Ce          , Ce          , Ce          , Gs^Bw\      , Gs          , Re          , Ss          , Ww          , Ss          
Ss          , Ss          , Ww          , Ww          , Hh^Fdf      , Mm          , Mm          , Mm          , Mm          , Mm          , Hh^Fdf      , Hh^Fdw      , Ss          , Re^Bw\      , Ss^Bw/      , Ss^Bw\      , Ss^Bw\      , Ss^Bw/      , Ss          , Re          , Ss^Vm       , Ww          , Ww          , Ss          
Ww          , Ww          , Ww          , Ww          , Hh^Fdf      , Mm          , Mm          , Mm          , Mm          , Mm          , Hh^Fdf      , Ss          , Re          , Re          , Re          , Ss          , Ss          , Ww          , Ss          , Ww          , Ww          , Ww          , Ww          , Ww          
Ww          , Ww          , Ss          , Ww          , Hh^Fdw      , Mm          , Mm          , Mm          , Mm          , Mm          , Hh^Fdf      , Gs^Fmf      , Re          , Re          , Ww          , Ww          , Gs^Fmf      , Ss          , Ww          , Ww          , Gs^Fp       , Gs^Fp       , Ww          , Ww          
Ss          , Gg          , Gg          , Ww          , Hh^Fdf      , Mm          , Mm          , Mm          , Mm          , Hh^Fdf      , Ss          , Ss          , Re          , Wo          , Wo          , Wo          , Ww          , Ss          , Ss          , Ss          , Ss          , Gs^Fmf      , Ss          , Ss          
Ss          , Gg^Vh       , Gg          , Ww          , Ww          , Hh^Fdf      , Hh^Fdf      , Mm          , Mm          , Hh^Fdf      , Ss          , Ss          , Ww^Bw|      , Wo          , Wo          , Wo          , Ww          , Ss          , Gg          , Ss          , Ww          , Ww          , Ss          , Ss          
Ss          , Gg          , Gg          , Gg          , Hh^Fdf      , Ww          , Hh^Fdf      , Hh^Fdw      , Hh^Fdf      , Hh^Fdf      , Ss          , Ss          , Ww^Bw|      , Wo          , Wo          , Wo          , Ww          , Ss          , Gg          , Ss          , Ww          , Wo          , Gg          , Gg          
Ww          , Gg          , Gg          , Gg          , Ss          , Ww          , Ww          , Ww          , Ww          , Hh^Fdf      , Ss^Vhs      , Ss          , Re          , Wo          , Wo          , Wo          , Ww          , Ww          , Ww          , Ww          , Ww          , Ww          , Gg^Vc       , Gg          
Wo          , Ww          , Gg          , Ss          , Ss          , Ss          , Ss          , Ww          , Ww          , Ww          , Ww^Bw/      , Re          , Ww          , Wo          , Wo          , Wo          , Ww          , Ww          , Ww          , Ww          , Ww          , Ww          , Gg          , Gg          
Xu          , Wo          , Ww          , Ss          , Xu          , Xu          , Xu          , Ss          , Ss          , Chw         , Gs^Fmf      , Ww          , Ww          , Ww          , Ww          , Ss          , Ss          , Ss          , Gs^Fmf      , Gs^Fmf      , Ss          , Gg          , Gg          , Gg          
Xu          , Xu          , Xu          , Xu          , Uu          , Ss          , Ss          , Xu          , Ss          , Re          , Gs^Fp       , Ww          , Ww          , Ss          , Ss          , Ss          , Hh          , Hh          , Hh^Dr       , Hh          , Hh          , Gg          , Gg          , Gg          
Xu          , Uu^Uf       , Uu          , Uu          , Xu          , Uu          , Xu          , Xu          , Gs^Fp       , Gs^Fmf      , Gs^Fmf      , Ww          , Ww          , Ss          , Hh          , Hh          , Xu          , Xu          , Xu          , Xu          , Xu          , Hh          , Hh          , Gg          
Xu          , Uu          , Xu          , Xu          , Uu          , Uu          , Xu          , Ss          , Ss          , Ww^Bw|      , Ww          , Wo          , Ww          , Ss          , Hh          , Xu          , Xu          , Uh          , Uh          , Uh          , Uu^Vu       , Xu          , Xu          , Hh^Dr       
Xu          , Ss          , Xu          , Uu          , Uu          , Ss          , Xu          , Ss          , Ww          , Ww^Bw|      , Wo          , Wo          , Ww          , Ss          , Hh          , Hh^Dr       , Xu          , Ss          , Uh          , Uh          , Uh          , Uh          , Uh          , Xu          
Xu          , Ss^Vm       , Uu^Uf       , Xu          , Xu          , Uu^Uf       , Xu          , Ss          , Ss          , Ww^Bw|      , Ww^Bw\      , Wo          , Hh          , Hh^Dr       , Xu          , Xu          , Uh          , Uh          , Xu          , Xu          , Xu          , Ss          , Uh          , Xu          
Xu          , Uu^Uf       , Xu          , Uu          , Xu          , Uu          , Uu          , Xu          , Xu          , Ss          , Ww          , Ww^Bw\      , Ss          , Xu          , Uu^Uf       , Ss          , Xu          , Xu          , Uh          , Uh          , Xu          , Xu          , Uh          , Xu          
Xu          , Uu          , Xu          , Uu          , Uh          , Xu          , Xu          , Uu          , Uu          , Xu          , Xu          , Xu          , Xu          , Uu^Ufi      , Uu^Uf       , Uh          , Xu          , Ss          , Ss          , Xu          , Uh          , Ss          , Uh          , Xu          
Xu          , Uu          , Uh          , Uh          , Uh          , Uu          , Uu          , Uh          , Uu          , Uu          , Uh          , Uu^Uf       , Uu^Uf       , Ss          , Ss          , Uh          , Uh          , Uh          , Uh          , Uh          , Uh          , Uh          , Uh          , Xu          
Xu          , Xu          , Xu          , Xu          , Xu          , Xu          , Xu          , Xu          , Xu          , Xu          , Xu          , Xu          , Xu          , Xu          , Xu          , Xu          , Xu          , Xu          , Xu          , Xu          , Xu          , Xu          , _s          , _s          
