border_size=1
usage=map

Gs^Fp       , Gs^Fmf      , Ww          , Gs^Fp       , Ss          , Ss          , Ss          , Gg          , Ss          , Ss          , Ss          , Ww          , Ww          , Ww          , Ww          , Ww          , Ww          , Ss          , Ww          , Ss          , Ww          , Ww          , Ww          , Ss          
Gs^Fmf      , Gs^Fp       , Gs^Fp       , Ww          , Ss          , Ss          , Chs^Bw/     , Ss          , Ss          , Ww          , Ss          , Ww          , Ss^Bw/      , Ss^Bw/      , Ss^Bw\      , Re^Bw/      , Ss^Bw\      , Ww          , Ss          , Ss          , Ss^Bw\      , Gg^Wm       , Ss          , Ss          
Gs^Fp       , Gs^Fmf      , Gs^Fp       , Gs^Fp       , Gs^Fmf      , Ss^Vhs      , Ss          , Ss^Bw\      , Ss^Bw/      , Ss^Bw\      , Ss^Bw/      , Ss^Bw/      , Ss^Bw/      , Ce          , Ce          , Ce          , Ce          , Ce          , Ss^Bw\      , Ss^Bw/      , Ss^Bw|      , Ss          , Ww          , Ss          
Gs^Fmf      , Gs^Fmf      , Gs^Fp       , Gs^Fp       , Ss          , Ss          , Ss          , Ss          , Ms^Vhha     , Hh^Fdf      , Ss          , Ss^Bw\      , Ss^Bw\      , Ce          , Ce          , Ce          , 1 Ce        , Ce          , Ww          , Ss          , Gll         , Ss          , Ss          , Ss          
Gs^Fp       , Gs^Fp       , Gs^Fp       , Gs^Fmf      , Hh^Fdf      , Hh^Fdf      , Hh^Fdf      , Hh^Fdf      , Mm          , Hh^Fdf      , Hh^Fdf      , Ss          , Ce          , Ww^Bw/      , Ce          , Ce          , Ce          , Ss^Bw\      , Ce          , Ss          , Gll         , Ss          , Ss          , Ss          
Ss          , Gs^Fmf      , Gll^Fmf     , Hh^Fdf      , Hh^Fdw      , Mm          , Mm          , Mm          , Mm          , Hh^Fdf      , Hh^Fdf      , Ss          , Ss^Bw/      , Ce          , Ce          , Ce          , Ce          , Ce          , Gs^Bw\      , Gll         , Gll         , Ss          , Ww          , Ss          
Ss          , Ss          , Ww          , Ww          , Hh^Fdf      , Mm          , Mm          , Mm          , Mm          , Mm          , Hh^Fdf      , Hh^Fdw      , Ss          , Re^Bw\      , Ss^Bw/      , Ss^Bw\      , Ss^Bw\      , Ss^Bw/      , Ss          , Gll         , Ss^Vm       , Ww          , Ww          , Ss          
Ww          , Ww          , Ww          , Ww          , Hh^Fdf      , Mm          , Mm          , Mm          , Mm          , Mm          , Hh^Fdf      , Ss          , Gll         , Gll         , Gll         , Ss          , Ss          , Ww          , Ss          , Ww          , Ww          , Ww          , Ww          , Ww          
Ww          , Ww          , Ss          , Ww          , Hh^Fdw      , Mm          , Mm          , Mm          , Mm          , Mm          , Hh^Fdf      , Gs^Fmf      , Gll         , Gll         , Ww          , Ww          , Gll^Fmf     , Ss          , Ww          , Ww          , Gll^Fp      , Gll^Fp      , Ww          , Ww          
Ss          , Gg          , Gg          , Ww          , Hh^Fdf      , Mm          , Mm          , Mm          , Mm          , Hh^Fdf      , Ss          , Ss          , Gll         , Wo          , Wo          , Wo          , Ww          , Ss          , Ss          , Ss          , Ss          , Gs^Fmf      , Ss          , Ss          
Ss          , Gg^Vh       , Gg          , Ww          , Ww          , Hh^Fdf      , Hh^Fdf      , Mm          , Mm          , Hh^Fdf      , Ss          , Ss          , Ww^Bw|      , Wo          , Wo          , Wo          , Ww          , Ss          , Gll         , Ss          , Ww          , Ww          , Ss          , Ss          
Ss          , Gg          , Gg          , Gg          , Hh^Fdf      , Ww          , Hh^Fdf      , Hh^Fdw      , Hh^Fdf      , Hh^Fdf      , Ss          , Ss          , Ww^Bw|      , Wo          , Wo          , Wo          , Ww          , Ss          , Gg          , Ss          , Ww          , Wo          , Gll         , Gll         
Ww          , Gg^Efm      , Gg^Efm      , Gg          , Ss          , Ww          , Ww          , Ww          , Ww          , Hh^Fdf      , Ss^Vhs      , Ss          , Gll^Es      , Wo          , Wo          , Wo          , Ww          , Ww          , Ww          , Ww          , Ww          , Ww          , Gg^Vc       , Gg          
Wo          , Ww^Ewf      , Gg^Efm      , Ss          , Ss          , Ss          , Ss          , Ww          , Ww          , Ww          , Ww^Bw/      , Gll         , Ww          , Wo          , Wo          , Wo          , Ww^Ewl      , Ww^Ewl      , Ww^Ewf      , Ww          , Ww          , Ww          , Gg^Eff      , Gg          
Xu          , Wo          , Ww          , Ss          , Xu          , Xu          , Xu          , Ss          , Ss          , Chw         , Gs^Fmf      , Ww          , Ww          , Ww          , Ww          , Ss          , Ss          , Ww^Ewl      , Ww^Ewf      , Ww^Ewl      , Ss          , Gg          , Gg          , Gg^Eff      
Xu          , Xu          , Xu          , Xu          , Uu          , Ss          , Ss          , Xu          , Ss          , Re          , Gs^Fp       , Ww          , Ww          , Ss          , Ss          , Ss          , Hh          , Hh^Es       , Hh^Dr       , Hh^Es       , Hh          , Gg          , Gll         , Gg          
Xu          , Uu^Uf       , Uu          , Uu          , Xu          , Uu          , Xu          , Xu          , Gs^Fp       , Gs^Fmf      , Gs^Fmf      , Ww          , Ww          , Ss          , Hh          , Hh          , Xu          , Xu          , Xu          , Xu          , Xu          , Hh          , Hh^Es       , Gll         
Xu          , Uu          , Xu          , Xu          , Uu          , Uu          , Xu          , Ss          , Ss          , Ww^Bw|      , Ww          , Wo          , Ww          , Ss          , Hh^Es       , Xu          , Xu          , Uh          , Uh          , Uh          , Uu^Vu       , Xu          , Xu          , Hh^Dr       
Xu          , Ss          , Xu          , Uu          , Uu          , Ss          , Xu          , Ss          , Ww          , Ww^Bw|      , Wo          , Wo          , Ww          , Ss          , Hh^Es       , Hh^Dr       , Xu          , Ss          , Uh          , Uh          , Uh          , Uh          , Uh          , Xu          
Xu          , Ss^Vm       , Uu^Uf       , Xu          , Xu          , Uu^Uf       , Xu          , Ss          , Ss          , Ww^Bw|      , Ww^Bw\      , Wo          , Hh^Es       , Hh^Dr       , Xu          , Xu          , Uh          , Uh          , Xu          , Xu          , Xu          , Ss          , Uh          , Xu          
Xu          , Uu^Uf       , Xu          , Uu          , Xu          , Uu          , Uu          , Xu          , Xu          , Ss          , Ww          , Ww^Bw\      , Sm          , Xu          , Uu^Uf       , Ss          , Xu          , Xu          , Uh          , Uh          , Xu          , Xu          , Uh          , Xu          
Xu          , Uu          , Xu          , Uu          , Uh          , Xu          , Xu          , Uu^Es       , Uu^Es       , Xu          , Xu          , Xu          , Xu          , Uu^Ufi      , Uu^Uf       , Uh          , Xu          , Ss          , Ss          , Xu          , Uh          , Ss          , Uh          , Xu          
Xu          , Uu          , Uh          , Uh          , Uh          , Uu^Es       , Uu^Es       , Uh          , Uu^Es       , Uu          , Uh          , Uu^Uf       , Uu^Uf       , Ss          , Ss          , Uh          , Uh          , Uh          , Uh          , Uh          , Uh          , Uh          , Uh          , Xu          
Xu          , Xu          , Xu          , Xu          , Xu          , Xu          , Xu          , Xu          , Xu          , Xu          , Xu          , Xu          , Xu          , Xu          , Xu          , Xu          , Xu          , Xu          , Xu          , Xu          , Xu          , Xu          , _s          , _s          
