border_size=1
usage=map

Ww          , Ww          , Ww          , Ww          , Ww          , Rp          , Rp          , Rp          , Rp          , Ss          , Ss          , Ss          , Rp          , Ss          , Ss          , Ss          , Ww          , Ww          , Ww          , Ww          , Rp          , Rp          , Ss          , Gs^Fp       , Ss          , Ss          , Ss          , Ss          , Ss          , Ss          , Ss          , Gs^Fdw      , Gs^Fdw      , Ss          , Ss          , Ss          , Ss          , Ss          , Ss          , Hh          , Gs^Fdw      , Rp          
Ww          , Ww          , Ww          , Ww          , Ww          , Ww          , Rp          , Rp^Dr       , Rp          , Rp          , Ss          , Ss          , Rp          , Rp          , Ss          , Ss          , Ww          , Ww          , Ww          , Ss          , Rp          , Rp^Dr       , Rp          , Ss          , Ss          , Ss          , Ss          , Ss          , Ss          , Ss          , Ss          , Rr^Vd       , Rp          , Ss          , Ss          , Ss          , Ss          , Ss          , Rp          , Rp          , Ww          , Ww          
Ss          , Ww          , Ww          , Ww          , Ww          , Ww          , Rp          , Rp          , Rp          , Rp          , Ss          , Ss          , Ss          , Ss          , Ss          , Ss          , Ss          , Ww          , Ww          , Rp          , Ss          , Rp          , Ss          , Ss          , Ss          , Ss          , Ss          , Ss          , Ss          , Ss          , Ss          , Ss          , Ss          , Ss          , Rp          , Ss          , Rp          , Rp          , Ss          , Ww          , Ss          , Ss          
Ss          , Ww          , Ww          , Wo          , Ww          , Ww          , Rp          , Rp          , Rp          , Ss          , Ss          , Ss          , Ss          , Ss          , Ss          , Ss          , Ss          , Ww          , Ww          , Rp          , Ss          , Ss          , Ss          , Ss          , Ss          , Ss          , Ss          , Ss          , Ss          , Ss          , Ss          , Ss          , Ss          , Ss          , Rp          , Rp^Dr       , Ww          , Ww          , Ww          , Ww          , Ss          , Ss          
Ww          , Ww          , Ww          , Ww          , Ww          , Ww          , Rp          , Rp^Dr       , Rp          , Ss          , Ss          , Ss          , Ss          , Ss          , Ss          , Ss          , Ww          , Ww          , Ww          , Rr^Vd       , Ss          , Ss          , Ss          , Ss          , Ss          , Ss          , Ss          , Ss          , Rp          , Rp          , Ss          , Rp          , Ss          , 1 Rp        , Rp          , Ww          , Ww          , Ww          , Ss          , Ss          , Ss          , Ss          
Ww          , Ww          , Ww          , Ww          , Ww          , Ss          , Rp          , Ss          , Rr^Vd       , Ss          , Ss          , Ss          , Ss          , Ss          , Ss          , Ss          , Ss          , Ww          , Ss          , Ss          , Ss          , Ss          , Rp          , Ss          , Ss          , Ss          , Ss          , Ss          , Rp^Dr       , Rp          , Rp          , Ss          , Ww          , Wwf         , Ww          , Ww          , Ww          , Wwf         , Ss          , Ss          , Ss          , Ss          
Ss          , Ww          , Ww          , Ww          , Ss          , Ss          , Ss          , Ss          , Ss          , Ss          , Ss          , Ss          , Ss          , Ss          , Ss          , Ss          , Ss          , Ss          , Ss          , Ss          , Ss          , Rp^Dr       , Rp          , Rp          , Ch          , Ss          , Rp^Dr       , Rp          , Rp          , Rp          , Rp          , Ww          , Ss          , Ww          , Rp          , Rp          , Ss          , Ss          , Ss          , Ss          , Ss          , Ss          
Ss          , Ss          , Ss          , Ss          , Rp          , Ss          , Rp          , Ss          , Ss          , Ss          , Rp          , Ss          , Ss          , Ss          , Ss          , Ss          , Ss          , Ss          , Ss          , Rp          , Rp          , Rp          , Rp          , Re          , Ss          , Ww^Bw\      , Rp          , Ss          , Rp          , Rp          , Ss          , Ss          , Rr^Vd       , Rp          , Rp          , Rp          , Ss          , Ss          , Ss          , Ss          , Ss          , Ss          
Rp          , Rp          , Rp          , Rp          , Rp          , Rp          , Rp^Dr       , Rp          , Ss          , Ss          , Rp          , Ss          , Ss          , Ss          , Ss          , Ss          , Hh          , Rp          , Rp          , Rp          , Re          , Re          , Re          , Re          , Ss          , Ss          , Rp          , Rp          , Ww          , Rp          , Ss          , Ss          , Ss          , Rp          , Rp          , Rp^Dr       , Rp^Dr       , Rp^Dr       , Rp          , Ss          , Ss          , Hh          
Rp          , Rp^Dr       , Rp          , Ww          , Rp          , Rp          , Rp          , Rp          , Rp          , Ss          , Ss          , Ss          , Ss          , Ss          , Ss          , Ss          , Ss          , Rp          , Rp          , Re          , Rp          , Rp          , Rp          , Ss          , Ss          , Ss          , Rp          , Rp          , Rp          , Rp          , Ss          , Ss          , Rp          , Rp          , Rp          , Rp^Dr       , Rp          , Rp          , Rp          , Ss          , Hh          , Hh          
Rp          , Rp          , Rp          , Rp          , Rp          , Rp          , Rp          , Ww          , Rp          , Ss          , Ss          , Ss          , Rp^Dr       , Rp          , Ss          , Ss          , Ss          , Hh          , Hh          , Re          , Rp          , Ss          , Ss          , Ss          , Ss          , Ss          , Ss          , Ss          , Ss          , Ss          , Rp          , Rp          , Rp          , Rp          , Rp          , Rp          , Rp          , Rp          , Rp          , Ss          , Hh          , Ss          
Rp          , Rp^Dr       , Rp          , Ss          , Ss          , Ss          , Ss          , Rp          , Rp          , Ss          , Ss          , Rp          , Rp          , Rp          , Ss          , Ss          , Ss          , Hh          , Hh          , Re          , Rp          , Ss          , Ss          , Ss          , Ss          , Ss          , Ss          , Ss          , Ss          , Rp          , Rp          , Rp          , Ss          , Rp          , Rp          , Ss          , Ss          , Rp          , Rp          , Rp          , Ss          , Ss          
Rp          , Rp          , Ss          , Ss          , Ss          , Ss          , Ss          , Ss          , Rp          , Ss          , Ss          , Rp          , Rp          , Rp          , Ss          , Ss          , Ss          , Rp          , Re          , Re          , Rr^Vd       , Ss          , Ss          , Ss          , Rp          , Ss          , Rp          , Rp          , Rp          , Ss          , Rp          , Rp          , Ss          , Ss          , Ss          , Ss          , Ss          , Rr^Vd       , Rp          , Rp          , Ss          , Ss          
Rp          , Ss          , Ss          , Ss          , Ss          , Ss          , Ss          , Ss          , Ss          , Ss          , Ss          , Ss          , Rp          , Rp          , Rp          , Ss          , Ss          , Ss          , Ww^Dr       , Ss          , Ss          , Ss          , Ss          , Rp          , Rp          , Rp          , Rp          , Rp^Dr       , Rp          , Ss          , Ss          , Ss          , Ss          , Ss          , Ss          , Ss          , Ss          , Ss          , Rp          , Rp          , Ss          , Ss          
Ss          , Ww          , Ss          , Ss          , Ss          , Ss          , Ss          , Ss          , Ss          , Ss          , Ss          , Ss          , Rp          , Ss          , Rp          , Ss          , Ss          , Ss          , Ww^Bw|      , Ss          , Ss          , Ss          , Ss          , Gs^Fdw      , Rr^Vd       , Rp          , Rp          , Rp          , Rp^Dr       , Rr^Vd       , Ss          , Ss          , Ss          , Ss          , Ss          , Ss          , Ss          , Ss          , Rp^Dr       , Rp          , Rp          , Rp          
Ss          , Ww          , Ww          , Ss          , Ss          , Ss          , Ss          , Ss          , Ss          , Ss          , Ss          , Ss          , Ss          , Ss          , Ss          , Rp          , Rp          , Ss          , Ww^Bw|      , Rp          , Ss          , Ss          , Gs^Fdw      , Ss          , Hh^Fdw      , Hh^Fdw      , Hh          , Gs^Fdw      , Hh^Fdw      , Gs^Fdw      , Ww          , Ss          , Ss          , Ss          , Ss          , Ss          , Hh          , Hh          , Hh          , Hh          , Rp          , Rp          
Ss          , Ww          , Ww          , Ss          , Ss          , Ss          , Ss          , Ss          , Ss          , Ss          , Ss          , Ss          , Ss          , Ss          , Ss          , Rp          , Ww          , Rp^Dr       , Re          , Rp          , Ss          , Ss          , Hh^Fdw      , Hh^Fdw      , Hh          , Hh          , Hh          , Hh          , Hh          , Gs^Fdw      , Gs^Fdw      , Ww          , Ss          , Ss          , Ss          , Ss          , Hh          , Hh^Dr       , Hh          , Hh          , Rp          , Rp          
Ss          , Ss          , Ss          , Ss          , Ss          , Ss          , Ss          , Ss          , Ss          , Gs^Fdw      , Ss          , Ss          , Ss          , Ss          , Ww          , Ww          , Ww          , Ww          , Re          , Rp          , Ss          , Hh^Fdw      , Hh          , Hh          , Hh          , Hh          , Hh          , Hh          , Hh          , Hh^Dr       , Hh^Dr       , Ss          , Ss          , Ss          , Ss          , Ss          , Ss          , Hh          , Rp          , Rp^Dr       , Rp          , Rp          
Ss          , Ss          , Ss          , Ss          , Ss          , Ss          , Ss          , Ss          , Ss          , Ss          , Ss          , Ss          , Ss          , Ss          , Ww          , Ww          , Ww          , Ww          , Re          , Rp          , Ss          , Ss          , Hh          , Hh          , Chs         , Chw         , Chs         , Hh          , Hh          , Hh^Fdw      , Ww          , Ss          , Ss          , Ss          , Ss          , Ss          , Ss          , Ss          , Ss          , Rp          , Rp          , Ss          
Ss          , Ss          , Ss          , Ww          , Ww          , Ww          , Ww          , Ww          , Rr^Vd       , Ss          , Ss          , Ss          , Ss          , Ww          , Ww          , Ww          , Ww          , Ww          , Re          , Rp          , Rp          , Ss          , Hh          , Hh          , Chw         , 4 Khs       , Chw         , Hh^Dr       , Hh          , Ww          , Ww          , Ww          , Ss          , Ss          , Ss          , Ss          , Ss          , Ss          , Rp          , Ss          , Ss          , Ss          
Ss          , Ss          , Ss          , Ww          , Ww          , Ww          , Ww          , Ww          , Ww          , Ss          , Ss          , Ss          , Ss          , Ww          , Ss          , Ww          , Ww          , Ww          , Re          , Rp          , Ww          , Ss          , Hh          , Hh          , Hh          , Chs         , Hh          , Hh          , Ss          , Ss          , Ss          , Ww          , Rr^Vd       , Ss          , Ss          , Ss          , Ss          , Ss          , Rp          , Ss          , Ss          , Ss          
Ww          , Ww          , Ss          , Ss          , Ww          , Ww          , Ww          , Ww          , Ww          , Ww          , Ww          , Ss          , Ss          , Ww          , Ww          , Ss          , Ss          , Ss          , Re          , Rp          , Rp          , Ss          , Ss          , Hh          , Hh          , Hh          , Ww          , Ww          , Ss          , Ss          , Ss          , Ss          , Ss          , Ss          , Ss          , Ss          , Ss          , Ss          , Ss          , Ss          , Ss          , Ss          
Ww          , Ss          , Ss^Vhs      , Ss          , Ss          , Ww          , Ww          , Ww          , Ww          , Ww          , Ww          , Ww          , Ww          , Ww          , Ss          , Ss          , Ww^Bw/      , Re          , Rp          , Rp^Dr       , Rp          , Rp          , Ss          , Ww          , Ww          , Ww          , Ss          , Ss          , Rp          , Rr^Vd       , Rp          , Ss          , Ss          , Ss          , Ss          , Ss          , Ss          , Ss          , Ww          , Rr^Vd       , Ww          , Ss          
Ss          , Ss          , Ss          , Ss          , Ss          , Ss          , Ww          , Ww          , Ww          , Ww          , Ww          , Ww          , Ss          , Ss          , Ss          , Chs         , Ss          , Ww          , Rp          , Rp          , Rp          , Ss          , Ss          , Ss          , Ss          , Ss          , Ss          , Rp          , Rp          , Rp          , Rp          , Ss          , Ss          , Ss          , Rp          , Ss          , Ss          , Ss          , Ww          , Ww          , Ww          , Ss          
Rp          , Rp          , Rp          , Rp          , Ss          , Ss          , Ss          , Ww          , Ww          , Ww          , Ww          , Ww          , Ww          , Ww          , Ww          , Ww^Bw|      , Ss          , Rp          , Rp          , Ww          , Rp          , Ss          , Ss          , Rr^Vd       , Rp          , Ss          , Ss          , Rp          , Rp          , Rp^Dr       , Rp          , Rp          , Ss          , Ss          , Ss          , Ss          , Ss          , Ss          , Ww          , Ww          , Ww          , Ss          
Rp          , Rp          , Rp^Dr       , Rp          , Rp          , Ss          , Ss          , Ss          , Ss          , Ss          , Ww          , Ww          , Ww          , Ww          , Re          , Re          , Ss          , Ss          , Rp          , Rp          , Rp          , Ss          , Rp          , Rp          , Rp^Dr       , Rp^Dr       , Ss          , Rp          , Rp          , Rp^Dr       , Rp^Dr       , Ss          , Ss          , Ss          , Ss          , Ss          , Ss          , Ss          , Ss          , Ww          , Ss          , Ss          
Ss          , Rp          , Rp          , Rp          , Rp          , Ss          , Ss          , Ss          , Ss          , Ss          , Ww          , Ww          , Ww          , Ww          , Re          , Hh          , Ss          , Rp          , Rp          , Rp          , Rp          , Ss          , Rp          , Rp          , Rp          , Rp          , Ss          , Ss          , Rp          , Rp          , Rp          , Rp          , Ss          , Ss          , Ss          , Ss          , Ss          , Rp          , Ss          , Ss          , Ss          , Ss          
Ss          , Ss          , Ss          , Ss          , Ss          , Ss          , Ss          , Ss          , Ss          , Rr^Vd       , Re          , Re          , Re          , Re          , Hh          , Hh          , Ss          , Ss          , Ss          , Ss          , Ss          , Rp          , Rp          , Rp          , Rp          , Rp          , Ss          , Ss          , Ww          , Ww          , Ww          , Ss          , Ss          , Ss          , Ss          , Ss          , Ss          , Ss          , Ss          , Ss          , Ss          , Ss          
Ss          , Ss          , Ss^Vm       , Ss          , Ss          , Ss          , Ss          , Ss          , Chr         , Ww^Bw/      , Hh          , Mm          , Mm          , Mm          , Mm          , Gg          , Gg          , Ss          , Ss          , Ss          , Rp          , Rp          , Rp          , Ss          , Rp          , Ss          , Ss          , Ss          , Ww          , Ww          , Ww          , Ww          , Ww          , Ss          , Ss          , Ss          , Ss          , Ss          , Ss          , Ss          , Ss          , Rp          
Ss          , Ss          , Ss          , Ss          , Ss          , Ss          , Rp^Dr       , Rp          , Ss          , Ss          , Hh          , Mm          , Mm          , Mm          , Hh          , Ss          , Gg          , Ss          , Ww          , Ss          , Ss          , Rp          , Rp          , Ss          , Ss          , Ss          , Ss          , Ss          , Ww          , Ww          , Ss          , Ww          , Ww          , Ww          , Rr^Vd       , Rp          , Rp          , Ss          , Ss          , Rp          , Rp^Dr       , Rp          
Ss          , Ss          , Ss          , Ss          , Ss          , Ss          , Rp          , Rp          , Ss          , Ss          , Hh          , Mm          , Mm          , Hh          , Ss          , Ss          , Rr^Vd       , Ww          , Ww          , Ww          , Ss          , Ss          , Ss          , Ss          , Ss          , Ss          , Ss          , Ww          , Ww          , Ss          , Rp          , Rp          , Rp          , Ww          , Rp          , Rp          , Rp          , Ss          , Rr^Vd       , Rp          , Rp          , Rp          
Ss          , Ss          , Ss          , Ss          , Ss          , Ss          , Rp          , Rp          , Ss          , Ss          , Ss          , Hh          , Hh          , Hh          , Ss          , Ss          , Ss          , Ww          , Ww          , Ww          , Ss          , Ss          , Ss          , Rp          , Ss          , Ss          , Ss          , Ss          , Rp          , Rp          , Rp          , Rp^Dr       , Rp          , Rp          , Rp          , Rp          , Ss          , Ww          , Ww          , Rp          , Rp          , Rp          
Ss          , Ss          , Ss          , Ss          , Ss          , Ss          , Ss          , Rr^Vd       , Ss          , Ss          , Ss          , Ss          , Ss          , Ss          , Ss          , Ss          , Ss          , Ww          , Ww          , Ww          , Ww          , Ss          , Rp          , Rp          , Rp          , Ss          , Ss          , Ss          , Ss          , Rp          , Ss          , Rp          , Rp          , Rp          , Rp          , Ss          , Ww          , Ww          , Ww          , Ss          , Ss          , Ss          
Ss          , Ss          , Ss          , Ss          , Ss          , Ss          , Ss          , Rp          , Ss          , Rp          , Ss          , Ss          , Ss          , Ss          , Ss          , Ss          , Ss          , Ss          , Ww          , Ww          , Ww          , Rp          , Rr^Vd       , Rp          , Ss          , Ss          , Ss          , Ss          , Ss          , Ss          , Ss          , Ss          , Ss          , Ss          , Rp          , Ss          , Ss          , Ss          , Ss          , Ss          , Ss          , Ss          
Ss          , Ss          , Ss          , Ss          , Ss          , Ss          , Ss          , Ss          , Rp^Dr       , Rp          , Ss          , Ss          , Ss          , Ss          , Ss          , Gs^Fdw      , Gs^Fdw      , Gs^Fdw      , Gs^Fdw      , Gs^Fdw      , Ww          , Rp          , Rp          , Rp          , Ss          , Ss          , Ww          , Ww          , Ww          , Ww          , Ww          , Ss          , Rr^Vd       , Ss          , Ss          , Ss          , Ss          , Ss          , Ss          , Ww          , Ww          , Ww          
Ss          , Ss          , Rp          , Ss          , Chw         , Ss^Vm       , Ss          , Rp          , Rp          , Rp          , Rp          , Ss          , Ss          , Rr^Vd       , Ss          , Ss          , Gs^Fdw      , Ss          , Gs^Fdw      , Ss          , Ss          , Ss          , Rp          , Ss          , Ss          , Ww          , Ww          , Ww          , Ww          , Ww          , Ww          , Ss          , Ss          , Ss          , Ss          , Ss          , Ss          , Ss          , Ww          , Ww          , Ww          , Ww          
Rp          , Rr^Vd       , Ss          , Chw         , 2 Khs       , Chw         , Ss          , Ss          , Ss          , Ss          , Ss          , Ss          , Ss          , Ss          , Ss          , Ss          , Ss          , Ss          , Ss          , Ss          , Ss          , Ss          , Ss          , Ss          , Ww          , Ww          , Ww          , Rp          , Ww          , Ww          , Ww          , Ww          , Ss          , Ss          , Ss          , Ss          , Ss          , Ss          , Ww          , Ww          , Ww          , Ww          
Ss          , Ss          , Ss          , Chs         , Chw         , Chw         , Rp          , Ss          , Ss          , Ss          , Ss          , Gs^Fdw      , Gs^Fdw      , Ss          , Ss          , Ss          , Ss          , Ss          , Ss          , Ss          , Ss          , Ss          , Ss          , Ww          , Ww          , Ww          , Ww          , Ww          , Ww          , Ww          , Ww          , Ww          , Ss          , Ss          , Ss          , Ss          , Ss          , Ss          , Ww          , Ww          , Ss          , Ss          
Ss          , Ss          , Ss          , Ss          , Ss          , Ss          , Rp          , Ss          , Ss          , Ss          , Ss          , Gs^Fdw      , Gs^Fdw      , Gs^Fdw      , Ss          , Ss          , Ss          , Ss          , Rr^Vd       , Ss          , Ss          , Ss          , Ww          , Ww          , Ww          , Ww          , Ww          , Ww          , Ww          , Ww          , Ww          , Ss          , Ss          , Ss          , Ss          , Ss          , Ss          , Ss          , Ss          , Ww          , Ss          , Ss          
Ss          , Ss          , Ss          , Ss          , Ss          , Ss          , Rp          , Ss          , Ss          , Ss          , Ss          , Ss          , Gs^Fdw      , Gs^Fdw      , Gs^Fdw      , Ss          , Ss          , Gg          , Ss          , Ss          , Ss          , Ss          , Ww          , Ww          , Ww          , Ww          , Ww          , Ww          , Ww          , Ss          , Ss          , Ss          , Ss          , Ss          , Ss          , Ss          , Ss          , Ww          , Ss          , Ss          , Ss          , Ww          
Gs^Fdw      , Gs^Fdw      , Gs^Fdw      , Ss          , Ss          , Ss          , Ss          , Rp          , Rr^Vd       , Ss          , Ss          , Ss          , Ss          , Gs^Fdw      , Gs^Fdw      , Gs^Fdw      , Gs^Fdw      , Gg          , Gg          , Ss          , Ss          , Ss          , Ww          , Ww          , Ww          , Ww          , Ww          , Ww          , Ss          , Ss          , Ss          , Ss          , Ss          , Ss          , Ss          , Ss          , Ss          , Ww          , Ww          , Ss          , Ss          , Ww          
Ss          , Ss          , Gs^Fdw      , Ss          , Ss          , Ss          , Ss          , Ss          , Rp          , Rp          , Rp          , Gs^Fdw      , Gs^Fdw      , Gs^Fdw      , Gs^Fdw      , Gs^Fdw      , Gs^Fdw      , Gs^Fdw      , Gs^Fdw      , Gg          , Ww          , Ww          , Ww          , Ww          , Ww          , Ww          , Ww          , Ww          , Ss          , Ss          , Gs^Fp       , Ss          , Ss          , Ss          , Ss          , Ss          , Ss          , Ss          , Ss          , Ss          , Ss          , Ww          
