border_size=1
usage=map

Ww          , Ww          , Ww          , Ww          , Ww          , Rp          , Rp^Es       , Rp^Es       , Rp^Es       , Ss          , Ss          , Ss          , Rp          , Ss          , Ss          , Ss          , Ww          , Ww          , Ww^Ewl      , Ww          , Rp^Es       , Rp^Es       , Ss          , Gs^Fp       , Ss          , Ss          , Ss          , Ss          , Ss          , Ss          , Ss          , Gs^Fdw      , Gs^Fdw      , Ss          , Ss          , Ss          , Ss          , Ss          , Ss          , Hh          , Gs^Fdw      , Rp          
Ww          , Ww          , Ww          , Ww          , Ww          , Ww          , Rp^Es       , Rp^Dr       , Rp^Es       , Rp          , Ss          , Ss          , Rp          , Rp          , Ss          , Ss          , Ww^Ewl      , Ww          , Ww          , Ss          , Rp^Es       , Rp^Dr       , Rp^Es       , Ss          , Ss          , Ss          , Ss          , Ss          , Ss          , Ss          , Ss          , Rr^Vd       , Rp          , Ss          , Ss          , Ss          , Ss          , Ss          , Rp          , Rp          , Ww          , Ww          
Ss          , Ww          , Ww          , Ww          , Ww          , Ww          , Rp          , Rp^Es       , Rp          , Rp          , Ss          , Ss          , Ss          , Ss          , Ss          , Ss          , Ss          , Ww^Ewf      , Ww          , Rp          , Ss          , Rp^Es       , Ss          , Ss          , Ss          , Ss          , Ww^Ewf      , Ss          , Ss          , Ss          , Ss          , Ss          , Ss          , Ss          , Rp^Es       , Ss          , Rp^Es       , Rp          , Ss          , Ww          , Ss          , Ss          
Ss          , Ww          , Ww          , Wo          , Ww          , Ww          , Rp^Es       , Rp^Es       , Rp^Es       , Ss          , Ss          , Ss          , Ss          , Ss          , Ss          , Ss          , Ww^Ewl      , Ww          , Ww          , Rp          , Ss          , Ss          , Ss          , Ss          , Ss          , Ss          , Ss          , Ss          , Ss          , Ss          , Ss          , Ss          , Ss          , Ss          , Rp^Es       , Rp^Dr       , Ww          , Ww          , Ww          , Ww          , Ss          , Ss          
Ww          , Ww          , Ww          , Ww          , Ww          , Ww          , Rp^Es       , Rp^Dr       , Rp^Es       , Ss          , Ss          , Ss          , Ss          , Ss          , Ss          , Ww^Ewl      , Ww          , Ww          , Ww          , Rr^Vd       , Ss          , Ss          , Ss          , Ss          , Ss          , Ss          , Ss          , Ss          , Rp^Es       , Rp          , Ss          , Rp          , Ss          , 1 Rp        , Rp          , Ww          , Ww          , Ww          , Ss          , Ss          , Ss          , Ss          
Ww          , Ww          , Ww          , Ww          , Ww          , Ss          , Rp          , Ss          , Rr^Vd       , Ss          , Ss          , Ss          , Ss          , Ss          , Ss          , Ss          , Ww^Ewf      , Ww          , Ss          , Ss          , Ss          , Ss          , Rp^Es       , Ss          , Ss          , Ss          , Ss          , Ss          , Rp^Dr       , Rp^Es       , Rp          , Ss          , Ww          , Wwf         , Ww          , Ww          , Ww          , Wwf         , Ss          , Ss          , Ww^Ewf      , Ss          
Ss          , Ww          , Ww          , Ww          , Ss          , Ss          , Ss          , Ss          , Ss          , Ss          , Ss          , Ss          , Ss          , Ss          , Ss          , Ss          , Ss          , Ss          , Ss          , Ss          , Ss          , Rp^Dr       , Rp^Es       , Rp          , Ch          , Ss          , Rp^Dr       , Rp^Es       , Rp^Es       , Rp^Es       , Rp          , Ww          , Ss          , Ww          , Rp          , Rp          , Ss          , Ss          , Ss          , Ww^Ewf      , Ww^Ewf      , Ss          
Ss          , Ss          , Ss          , Ss          , Rp          , Ss          , Rp^Es       , Ss          , Ss          , Ss          , Rp          , Ss          , Ss          , Ss          , Ss          , Ss          , Ss          , Ss          , Ss          , Rp          , Rp          , Rp^Es       , Rp          , Re          , Ss          , Ww^Bw\      , Rp^Es       , Ss          , Rp          , Rp          , Ss          , Ss          , Rr^Vd       , Rp          , Rp^Es       , Rp^Es       , Ss          , Ss          , Ss          , Ss          , Ss          , Ss          
Rp^Es       , Rp^Es       , Rp^Es       , Rp          , Rp          , Rp^Es       , Rp^Dr       , Rp^Es       , Ss          , Ss          , Rp          , Ss          , Ss          , Ss          , Ss          , Ss          , Hh          , Rp          , Rp          , Rp          , Re          , Re          , Re          , Re          , Ss          , Ss          , Rp          , Rp          , Ww          , Rp          , Ss          , Ss          , Ss          , Rp          , Rp^Es       , Rp^Dr       , Rp^Dr       , Rp^Dr       , Rp^Es       , Ss          , Ss          , Hh          
Rp^Es       , Rp^Dr       , Rp^Es       , Ww          , Rp          , Rp^Es       , Rp^Es       , Rp^Es       , Rp          , Ss          , Ss          , Ss          , Ss          , Ss          , Ss          , Ss          , Ss          , Rp^Em       , Rp          , Re          , Rp          , Rp          , Rp          , Ss          , Ss          , Ss          , Rp          , Rp          , Rp          , Rp          , Ss          , Ss          , Rp          , Rp          , Rp^Es       , Rp^Dr       , Rp^Es       , Rp^Es       , Rp          , Ss          , Hh          , Hh          
Rp^Es       , Rp^Es       , Rp^Es       , Rp^Em       , Rp^Em       , Rp^Em       , Rp^Em       , Ww          , Rp^Em       , Ss          , Ss          , Ss          , Rp^Dr       , Rp^Es       , Ss          , Ss          , Ss          , Hh          , Hh          , Re          , Rp          , Ss          , Ss          , Ss          , Ss          , Ss          , Ss          , Ss          , Ss          , Ss          , Rp          , Rp          , Rp          , Rp          , Rp          , Rp^Es       , Rp          , Rp          , Rp          , Ss          , Hh          , Ss          
Rp^Es       , Rp^Dr       , Rp^Es       , Ss          , Ss          , Ss          , Ss          , Rp^Em       , Rp^Em       , Ss          , Ss          , Rp^Es       , Rp^Es       , Rp^Es       , Ss          , Ss          , Ss          , Hh          , Hh          , Re          , Rp          , Ss          , Ss          , Ss          , Ss          , Ss          , Ss          , Ss          , Ss          , Rp          , Rp          , Rp          , Ss          , Rp^Em       , Rp          , Ss          , Ss          , Rp          , Rp          , Rp          , Ss          , Ss          
Rp          , Rp^Es       , Ss          , Ss          , Ss          , Ss          , Ss          , Ss          , Rp^Em       , Ss          , Ss          , Rp          , Rp          , Rp          , Ss          , Ss          , Ss          , Rp          , Re^Es       , Re          , Rr^Vd       , Ss          , Ss          , Ss          , Rp          , Ss          , Rp^Es       , Rp^Es       , Rp^Es       , Ss          , Rp          , Rp          , Ss          , Ss          , Ss          , Ss          , Ss          , Rr^Vd       , Rp          , Rp          , Ss          , Ss          
Rp          , Ss          , Ss          , Ss          , Ss          , Ss          , Ss          , Ss          , Ss          , Ss          , Ss          , Ss          , Rp          , Rp          , Rp          , Ss          , Ss          , Ss          , Ww^Dr       , Ss          , Ss          , Ss          , Ss          , Rp          , Rp          , Rp          , Rp^Es       , Rp^Dr       , Rp^Es       , Ss          , Ss          , Ss          , Ss          , Ss          , Ss          , Ss          , Ss          , Ss          , Rp^Es       , Rp          , Ss          , Ss          
Ss          , Ww          , Ss          , Ss          , Ss          , Ss          , Ss          , Ss          , Ss          , Ss          , Ss          , Ss          , Rp          , Ss          , Rp          , Ss          , Ss          , Ss          , Ww^Bw|      , Ss          , Ss          , Ss          , Ss          , Gs^Fdw      , Rr^Vd       , Rp          , Rp          , Rp^Es       , Rp^Dr       , Rr^Vd       , Ss          , Ss          , Ss          , Ss          , Ss          , Ss          , Ss          , Ss          , Rp^Dr       , Rp^Es       , Rp          , Rp          
Ss          , Ww          , Ww          , Ss          , Ss          , Ss          , Ss          , Ss          , Ss          , Ss          , Ss          , Ss          , Ss          , Ss          , Ss          , Rp          , Rp^Es       , Ss          , Ww^Bw|      , Rp          , Ss          , Ss          , Gs^Fdw      , Ss          , Hh^Fdw      , Hh^Fdw      , Hh          , Gs^Fdw      , Hh^Fdw      , Gs^Fdw      , Ww          , Ss          , Ss          , Ss          , Ss          , Ss          , Hh^Es       , Hh^Es       , Hh^Es       , Hh^Es       , Rp          , Rp          
Ss          , Ww          , Ww          , Ss          , Ss          , Ss          , Ss          , Ss          , Ss          , Ss          , Ss          , Ss          , Ss          , Ss          , Ss          , Rp          , Ww          , Rp^Dr       , Re          , Rp          , Ss          , Ss          , Hh^Fdw      , Hh^Fdw      , Hh          , Hh          , Hh          , Hh          , Hh^Es       , Gs^Fdw      , Gs^Fdw      , Ww          , Ss          , Ss          , Ss          , Ss          , Hh^Es       , Hh^Dr       , Hh^Es       , Hh^Es       , Rp^Es       , Rp          
Ss          , Ss          , Ss          , Ss          , Ss          , Ss          , Ss          , Ss          , Ss          , Gs^Fdw      , Ss          , Ss          , Ss          , Ss          , Ww          , Ww          , Ww          , Ww          , Re          , Rp          , Ss          , Hh^Fdw      , Hh          , Hh          , Hh          , Hh          , Hh          , Hh          , Hh^Es       , Hh^Dr       , Hh^Dr       , Ss          , Ss          , Ss          , Ss          , Ss          , Ss          , Hh^Es       , Rp^Es       , Rp^Dr       , Rp^Es       , Rp          
Ss          , Ss          , Ss          , Ss          , Ss          , Ss          , Ss          , Ss          , Ss          , Ss          , Ss          , Ss          , Ss          , Ss          , Ww          , Ww          , Ww          , Ww          , Re          , Rp          , Ss          , Ss          , Hh          , Hh          , Chs         , Chw         , Chs         , Hh          , Hh          , Hh^Fdw      , Ww          , Ss          , Ss          , Ss          , Ss          , Ss          , Ss          , Ss          , Ss          , Rp^Es       , Rp          , Ss          
Ss          , Ss          , Ss          , Ww          , Ww          , Ww          , Ww          , Ww          , Rr^Vd       , Ss          , Ss          , Ss          , Ss          , Ww          , Ww          , Ww          , Ww          , Ww          , Re          , Rp          , Rp          , Ss          , Hh          , Hh          , Chw         , 4 Khs       , Chw         , Hh^Dr       , Hh          , Ww          , Ww          , Ww          , Ss          , Ss          , Ss          , Ss          , Ss          , Ss          , Rp          , Ss          , Ss          , Ss          
Ss          , Ss          , Ss          , Ww          , Ww          , Ww          , Ww          , Ww          , Ww          , Ss          , Ss          , Ss          , Ss          , Ww          , Ss          , Ww          , Ww          , Ww          , Re          , Rp          , Ww          , Ss          , Hh          , Hh          , Hh          , Chs         , Hh          , Hh          , Ss          , Ss          , Ss          , Ww          , Rr^Vd       , Ss          , Ss          , Ss          , Ss          , Ss          , Rp          , Ss          , Ss          , Ss          
Ww          , Ww          , Ss          , Ss          , Ww          , Ww          , Ww          , Ww          , Ww          , Ww          , Ww          , Ss          , Ss          , Ww          , Ww          , Ss          , Ss          , Ss          , Re^Es       , Rp^Es       , Rp^Es       , Ss          , Ss          , Hh          , Hh          , Hh          , Ww          , Ww          , Ss          , Ss          , Ss          , Ss          , Ss          , Ss          , Ss          , Ss          , Ss          , Ss          , Ss          , Ss          , Ss          , Ss          
Ww          , Ss          , Ss^Vhs      , Ss          , Ss          , Ww          , Ww          , Ww          , Ww          , Ww          , Ww          , Ww          , Ww          , Ww          , Ss          , Ss          , Ww^Bw/      , Re          , Rp^Es       , Rp^Dr       , Rp^Es       , Rp          , Ss          , Ww          , Ww          , Ww          , Ss          , Ss          , Rp          , Rr^Vd       , Rp          , Ss          , Ss          , Ss          , Ss          , Ss          , Ss          , Ss          , Ww          , Rr^Vd       , Ww          , Ss          
Ss          , Ss          , Ss          , Ss          , Ss          , Ss          , Ww          , Ww          , Ww          , Ww          , Ww          , Ww          , Ss          , Ss          , Ss          , Chs         , Ss          , Ww          , Rp          , Rp^Es       , Rp          , Ss          , Ss          , Ss          , Ss          , Ss          , Ss          , Rp          , Rp^Es       , Rp^Es       , Rp^Es       , Ss          , Ss          , Ss          , Rp          , Ss          , Ss          , Ss          , Ww          , Ww          , Ww          , Ss          
Rp          , Rp          , Rp^Es       , Rp          , Ss          , Ss          , Ss          , Ww          , Ww          , Ww          , Ww          , Ww          , Ww          , Ww          , Ww          , Ww^Bw|      , Ss          , Rp          , Rp          , Ww          , Rp          , Ss          , Ss          , Rr^Vd       , Rp^Es       , Ss          , Ss          , Rp          , Rp^Es       , Rp^Dr       , Rp^Es       , Rp          , Ss          , Ss          , Ss          , Ss          , Ss          , Ss          , Ww          , Ww          , Ww          , Ss          
Rp          , Rp^Es       , Rp^Dr       , Rp^Es       , Rp          , Ss          , Ss          , Ss          , Ss          , Ss          , Ww          , Ww          , Ww          , Ww          , Re          , Re          , Ss          , Ss          , Rp          , Rp          , Rp          , Ss          , Rp          , Rp^Es       , Rp^Dr       , Rp^Dr       , Ss          , Rp          , Rp^Es       , Rp^Dr       , Rp^Dr       , Ss          , Ss          , Ss          , Ss          , Ss          , Ss          , Ss          , Ss          , Ww          , Ss          , Ss          
Ss          , Rp^Es       , Rp^Es       , Rp^Es       , Rp          , Ss          , Ss          , Ss          , Ss          , Ss          , Ww          , Ww          , Ww          , Ww          , Re          , Hh          , Ss          , Rp          , Rp          , Rp          , Rp          , Ss          , Rp          , Rp^Es       , Rp^Es       , Rp^Es       , Ss          , Ss          , Rp          , Rp^Es       , Rp^Es       , Rp^Es       , Ss          , Ss          , Ss          , Ss          , Ss          , Rp          , Ss          , Ss          , Ss          , Ss          
Ss          , Ss          , Ss          , Ss          , Ss          , Ss          , Ss          , Ss          , Ss          , Rr^Vd       , Re          , Re          , Re          , Re          , Hh          , Hh          , Ss          , Ss          , Ss          , Ss          , Ss          , Rp          , Rp          , Rp          , Rp          , Rp          , Ss          , Ss          , Ww          , Ww          , Ww          , Ss          , Ss          , Ss          , Ss          , Ss          , Ss          , Ss          , Ss          , Ss          , Ss          , Ss          
Ss          , Ss          , Ss^Vm       , Ss          , Ss          , Ss          , Ss          , Ss          , Chr         , Ww^Bw/      , Hh          , Mm          , Mm          , Mm          , Mm          , Gg          , Gg          , Ss          , Ss          , Ss          , Rp          , Rp          , Rp          , Ss          , Rp          , Ss          , Ss          , Ss          , Ww          , Ww          , Ww          , Ww          , Ww          , Ss          , Ss          , Ss          , Ss          , Ss          , Ss          , Ss          , Ss          , Rp          
Ss          , Ss          , Ss          , Ss          , Ss          , Ss          , Rp^Dr       , Rp^Es       , Ss          , Ss          , Hh          , Mm          , Mm          , Mm          , Hh          , Ss          , Gg          , Ss          , Ww          , Ss          , Ss          , Rp          , Rp          , Ss          , Ss          , Ss          , Ss          , Ss          , Ww          , Ww          , Ss          , Ww          , Ww          , Ww          , Rr^Vd       , Rp          , Rp          , Ss          , Ss          , Rp^Es       , Rp^Dr       , Rp^Es       
Ss          , Ss          , Ww^Ewl      , Ss          , Ss          , Ss          , Rp^Es       , Rp^Es       , Ss          , Ss          , Hh          , Mm          , Mm          , Hh          , Ss          , Ss          , Rr^Vd       , Ww          , Ww          , Ww          , Ss          , Ss          , Ss          , Ss          , Ss          , Ss          , Ss          , Ww          , Ww          , Ss          , Rp^Es       , Rp^Es       , Rp^Es       , Ww          , Rp          , Rp          , Rp          , Ss          , Rr^Vd       , Rp^Es       , Rp^Es       , Rp^Es       
Ww^Ewl      , Ww^Ewl      , Ww^Ewl      , Ss          , Ss          , Ss          , Rp          , Rp          , Ss          , Ss          , Ss          , Hh          , Hh          , Hh          , Ss          , Ss          , Ss          , Ww          , Ww          , Ww          , Ss          , Ss          , Ss          , Rp          , Ss          , Ss          , Ss          , Ss          , Rp          , Rp          , Rp^Es       , Rp^Dr       , Rp^Es       , Rp          , Rp          , Rp          , Ss          , Ww          , Ww          , Rp          , Rp          , Rp          
Ss          , Ww^Ewl      , Ww^Ewl      , Ww^Ewl      , Ss          , Ss          , Ss          , Rr^Vd       , Ss          , Ss          , Ss          , Ss          , Ss          , Ss          , Ss          , Ss          , Ss          , Ww          , Ww          , Ww          , Ww          , Ss          , Rp          , Rp          , Rp          , Ss          , Ss          , Ss          , Ss          , Rp          , Ss          , Rp^Es       , Rp          , Rp          , Rp          , Ss          , Ww          , Ww          , Ww          , Ss          , Ss          , Ss          
Ss          , Ss          , Ss          , Ss          , Ss          , Ss          , Ss          , Rp          , Ss          , Rp          , Ss          , Ss          , Ss          , Ss          , Ss          , Ss          , Ss          , Ss          , Ww          , Ww          , Ww          , Rp          , Rr^Vd       , Rp          , Ss          , Ss          , Ss          , Ss          , Ss          , Ss          , Ss          , Ss          , Ss          , Ss          , Rp          , Ss          , Ss          , Ss          , Ss          , Ss          , Ss          , Ss          
Ss          , Ss          , Ss          , Ss          , Ss          , Ss          , Ss          , Ss          , Rp^Dr       , Rp^Es       , Ss          , Ss          , Ss          , Ss          , Ss          , Gs^Fdw      , Gs^Fdw      , Gs^Fdw      , Gs^Fdw      , Gs^Fdw      , Ww          , Rp          , Rp          , Rp          , Ss          , Ss          , Ww          , Ww          , Ww          , Ww          , Ww          , Ss          , Rr^Vd       , Ss          , Ss          , Ss          , Ss          , Ss          , Ss          , Ww          , Ww          , Ww          
Ss          , Ss          , Rp          , Ss          , Chw         , Ss^Vm       , Ss          , Rp^Es       , Rp^Es       , Rp          , Rp          , Ss          , Ss          , Rr^Vd       , Ss          , Ss          , Gs^Fdw      , Ss          , Gs^Fdw      , Ss          , Ss          , Ss          , Rp          , Ss          , Ss          , Ww          , Ww          , Ww          , Ww          , Ww          , Ww          , Ss          , Ss          , Ss          , Ss          , Ss          , Ss          , Ss          , Ww          , Ww          , Ww          , Ww          
Rp          , Rr^Vd       , Ss          , Chw         , 2 Khs       , Chw         , Ss          , Ss          , Ss          , Ss          , Ss          , Ss          , Ss          , Ss          , Ss          , Ss          , Ss          , Ss          , Ss          , Ss          , Ss          , Ss          , Ss          , Ss          , Ww          , Ww          , Ww          , Rp          , Ww          , Ww          , Ww          , Ww          , Ss          , Ss          , Ss          , Ss          , Ss          , Ss          , Ww          , Ww          , Ww          , Ww          
Ss          , Ss          , Ss          , Chs         , Chw         , Chw         , Rp          , Ss          , Ww^Ewf      , Ss          , Ss          , Gs^Fdw      , Gs^Fdw      , Ss          , Ss          , Ss          , Ss          , Ss          , Ss          , Ss          , Ss          , Ss          , Ss          , Ww          , Ww          , Ww          , Ww          , Ww          , Ww          , Ww          , Ww          , Ww          , Ss          , Ss          , Ss          , Ss          , Ss          , Ss          , Ww          , Ww          , Ss          , Ss          
Ss          , Ss          , Ww^Ewf      , Ss          , Ss          , Ss          , Rp          , Ss          , Ww^Ewf      , Ww^Ewf      , Ss          , Gs^Fdw      , Gs^Fdw      , Gs^Fdw      , Ss          , Ss          , Ss          , Ss          , Rr^Vd       , Ss          , Ss          , Ss          , Ww          , Ww          , Ww          , Ww          , Ww          , Ww          , Ww          , Ww          , Ww          , Ss          , Ss          , Ss          , Ss          , Ss          , Ss          , Ss          , Ss          , Ww          , Ss          , Ss          
Ss          , Ss          , Ss          , Ww^Ewf      , Ww^Ewf      , Ss          , Rp          , Ss          , Ss          , Ss          , Ss          , Ss          , Gs^Fdw      , Gs^Fdw      , Gs^Fdw      , Ss          , Ss          , Gg^Efm      , Ss          , Ss          , Ss          , Ss          , Ww          , Ww          , Ww          , Ww          , Ww          , Ww          , Ww          , Ss          , Ss          , Ss          , Ss          , Ss          , Ss          , Ss          , Ss          , Ww          , Ss          , Ss          , Ss          , Ww          
Gs^Fdw      , Gs^Fdw      , Gs^Fdw      , Ss          , Ww^Ewf      , Ss          , Ss          , Rp          , Rr^Vd       , Ss          , Ss          , Ss          , Ss          , Gs^Fdw      , Gs^Fdw      , Gs^Fdw      , Gs^Fdw      , Gg^Efm      , Gg^Efm      , Ss          , Ss          , Ss          , Ww          , Ww          , Ww          , Ww          , Ww          , Ww          , Ss          , Ss          , Ss          , Ss          , Ss          , Ss          , Ss          , Ss          , Ss          , Ww          , Ww          , Ss          , Ss          , Ww          
Ss          , Ss          , Gs^Fdw      , Ss          , Ss          , Ss          , Ss          , Ss          , Rp          , Rp          , Rp          , Gs^Fdw      , Gs^Fdw      , Gs^Fdw      , Gs^Fdw      , Gs^Fdw      , Gs^Fdw      , Gs^Fdw      , Gs^Fdw      , Gg          , Ww          , Ww          , Ww          , Ww          , Ww          , Ww          , Ww          , Ww          , Ss          , Ss          , Gs^Fp       , Ss          , Ss          , Ss          , Ss          , Ss          , Ss          , Ss          , Ss          , Ss          , Ss          , Ww          
